היטפילד	hetfield
סמולי	smalley
קאבאליירי	cavalieri
באצ'אן	bachchan
ויגו	viggo
סזוק	szoke
ברני	bernie
פולשי	pulci
ברונטי	bronte
ג'וזף	joseph
קורנויל	cornwell
מולר	muller
אתיופיאן	ethiopian
טאלבלו	talebloo
מאדסן	madsen
דאטן	dutton
אנטארקטיקא	antarctica
לין	lynn
פופאקיס	poupakis
פריידון	ferydoon
האלונין	halonen
קאן	cannes
סינדי	cindy
גאיטאנו	gaetano
גידיס	geddes
וינטמיליא	ventimiglia
ביליני	bellini
האסיקורא	hasekura
פיסט	feist
נאטאלי	natale
קומאר	kumar
פרידריק	fredrik
סידיג	siddig
קומאי	kumai
קיטס	kitts
בירטו	berto
קולוראדו	colorado
ארטורו	arturo
סטאם	stam
הרבן	herbin
סקי	seki
גרישאם	grisham
ג'ובאנא	giovanna
בלאנט	blunt
טוקימונה	tokimune
מיינוב	minobe
קאנטור	cantor
מאטיאס	matthias
בסרי	basri
לארסון	larsson
ראנדאל	randall
פירי	peary
באראזאיט	barazite
פארמנידס	parmenides
פוסידון	poseidon
סאטו	satu
גאמארא	gamarra
ברגמאן	bergman
פאטפאט	fatfat
ריוטארו	ryutaro
צ'נן	chenene
שבצ'נקו	shevchenko
סאנטומי	sanetomi
זגלול	zaghloul
פידרוס	pedros
הארא	hara
אוזבקיסטאן	uzbekistan
עריף	arief
שמאס	shammas
נארא	nara
לייגל	laigle
עומר	oumar
אריאל	ariel
ניסנית	nisanit
קוני	connie
קוראני	kuranyi
בקרי	bakri
ניקולאס	nicolas
דרוגבא	drogba
פיליני	fellini
מיליטו	milito
ברידי	brede
מאסטריכט	maastricht
מילוד	miloud
אילאם	eelam
מאיקל	michael
קלאשניקוב	kalashnikov
מפומאלאנגא	mpumalanga
נומאן	numan
רוביו	rubio
לאטינא	latina
קדומים	kedumim
לו	law
ברידג'ז	bridges
שמסול	shamsul
אסד	asad
נסים	nissim
פוטין	putin
אלמוכטאר	mukhtar
דיוניסוס	dionysus
עובדיה	ovadia
פאליסטר	pallister
קאיטל	keitel
טיקופיא	tikopia
איפיל	ifil
גריר	grier
פרידמאן	friedmann
נורפולק	norfolk
דבורה	dvora
דוצ'ב	dotchev
לובומיר	ľubomir
לאפוינטי	lafuente
שטאודינגר	staudinger
סימיאן	simeon
מקסיקו	mexico
נג'אח	najah
הוגינס	huygens
דאגר	dagher
טיטו	titu
בורגיס	burgess
בארטלט	bartlett
ארדביל	ardabil
אנאטולי	anatoly
טיראסומא	terasoma
אדולף	adolf
מאגדה	magda
דונאטילו	donatello
מאזאריק	masaryk
סאקוראי	sakurai
סערי	saari
פולק	faulk
מוראליס	morales
צ'מראן	chamran
ברנאדוט	bernadotte
שאכט	schacht
סוייל	swaile
סואנק	swank
רונן	ronen
סנטיאגו	santiago
מאטאו	matteo
קאסין	cassin
דום	doom
קאניזאריס	canizares
זיטליץ	zetlitz
סטונטון	staunton
ייבון	yvonne
אוסטראלופיתקס	australopithecus
קובושי	kobushi
היטמאן	hitman
רושאן	roshan
ריקארדו	riccardo
ואלקוט	walcott
אסקולי	ascoli
עיאן	ayan
היפוליטו	hipolito
הינקס	heynckes
גאיטאן	gaetan
רומארין	romarin
גיאן	gyan
פאטינסון	pattinson
קויט	kuyt
סמיטנא	smetana
גאבריאלה	gabriela
פיודור	feodor
סירבר	server
קורל	curl
ע'גמי	ajami
נורתאם	northam
הירוטא	hirota
מובארק	mubarek
מסאלי	messali
ספירוני	sperone
מאדיסן	madison
וייקארט	weikart
גאזיאנטפ	gaziantep
פולוק	pollock
קארולאינא	carolina
בוזק	buzek
בילא	bela
סודוקו	sudoku
ויסקונסן	wisconsin
טינוריו	tenorio
טנזאניא	tanzania
מאצ'ו	macho
מארקומאני	marcomanni
ספיגלר	spiegler
ואיזמאן	wiseman
בירנר	berner
מילוטינוביטש	milutinovic
סני	ceni
קובאליוב	kovalyov
ניהודא	nehoda
נילאסי	nyilasi
הוצ'ו	hochu
מלחם	melhem
רול	ruhl
וארט	vaart
הומאיון	homayoun
ג'רארד	gerard
בקסי	bksy
האסיק	hasek
זייביאר	xavier
סטיוארט	stewart
בוסון	buson
דבי	deby
ארלין	arlen
שרגא	shraga
ריגוברט	rigobert
אנדו	ando
ג'אנקו	junko
קימי	kimi
אלבאיאטי	albayyati
מימי	mimi
מאתאי	maathai
דסאי	desai
מיריאם	myriam
הראקליוס	heraclius
ג'יימסון	jameson
דיאטא	diatta
נולבירטו	nolberto
רוקמונד	rockmond
סאנו	sanou
בלקאסם	belkacem
נאש	nash
בילאל	bilal
פראנקי	franky
שועיב	shoaib
דיאב	dhiab
וודוארד	woodward
מיסזולי	meszoly
טראנסניסטריא	transnistria
פורטאס	portas
נחשון	nachshon
טרוי	troy
טאיגר	tiger
מוטיו	mutiu
מונסף	monsef
ג'מיסון	jamieson
רוט	rott
לאסאנא	lassana
גאסקל	gaskell
נביל	nabeel
גורפיגי	gurpegui
מיניגאזו	menegazzo
סאנטיני	santini
שעבאן	shaaban
עארף	aref
קורליוני	corleone
שאנדונג	shandong
תיודור	theodore
קופולא	coppola
סאקר	saqr
פיונא	fiona
מאראתון	marathon
קיטירינג	kettering
סו	so
שעת	shaath
מוטוקו	motoko
ג'ו	jo
גאבידון	gabbidon
סילברסטון	silverstone
איפטאר	iftar
נורהאליזה	nurhaliza
בוניסל	bonnissel
דולסי	dulce
חרקת	harakat
צ'אק	chuck
מראקשי	marrakchi
טיצ'י	tichy
פקראדוני	pakradouni
אירופלוט	aeroflot
צ'כוב	chekhov
יונתן	yonatan
אולמרט	olmert
נוזארה	nouzaret
בלייבי	blaby
הידיקאטסו	hidekatsu
הילי	healey
טוג'אן	toujan
כפר	kfar
קאברילו	cabrillo
קורפו	corfu
מטרופוליטאנא	metropolitana
עפאר	afar
מונטמארטר	montmartre
רזק	razak
קוטוקו	kotoko
נור	noor
לוקאס	lucas
בוליאן	buljan
מרניסי	mernissi
לורז	lurz
הישאם	hicham
מאסאצ'ו	masaccio
סוזא	souza
מארטילי	martelli
הרארי	harari
קומלינוביטש	komljenovic
יוי	yui
מיטן	metin
ג'ורג'א	georgia
מילאניזיא	melanesia
ואלינטיא	valentia
טוניסיה	tunisia
פאפוליאס	papoulias
סימונוב	simonov
בונראקו	bunraku
צ'יסלאב	czeslaw
עדן	aden
הול	hall
ביילא	biella
עדן	eden
אפופיס	apophis
שירזינגר	scherzinger
קאריאר	carrier
סטיפטר	stifter
טולדו	toldo
קאנט	kant
שימינא	ximena
מוראוסקי	murawski
מוטעב	moteab
פינוקיו	pinocchio
יתום	yatom
וינטרא	vyntra
פאיפס	pipes
טורטוסא	tortosa
מיסקינא	myskina
מיזורי	missouri
ביקיט	beckett
שהו	shehu
קאהן	kahn
ג'ונדיאד	jundiaad
ביג'וטאט	bijotat
סוקור	sukur
מאגאת	magath
נותר	noether
מאיומי	mayumi
הכובש	hakovesh
סידארוס	sedarous
מר	mer
מארילאנד	maryland
קיריבאטי	kiribati
דר	der
הייזבירט	haysbert
דיביריטש	deveric
גר	ger
פולקי	fulci
פפסי	pepsi
מוחמד	muhamed
חימנז	jimenez
נורייגא	noriega
קרו	crowe
מאדרי	madre
אלין	elin
ג'ויא	joya
אלמודובאר	almodovar
באטיסטי	battisti
שוש	shosh
ישעיהו	yeshayahu
פונקה	funke
בירי	berry
דאביסון	davison
דאנקירק	dunkirk
וינסנט	vincent
בויט	voight
קראמי	karami
הופמאן	hoffman
בירגוניו	bergougnoux
הירנאן	hernan
לרבי	lerby
מוטראם	mottram
פיאנס	fiennes
נורילסק	norilsk
קאזאז	kazaz
דראגונייר	dragonair
בארטולומיו	bartolomeo
מדלידלי	mdledle
קאזאן	kazan
ברהום	barhom
פרידיריק	frederick
קומז	combs
בסלאן	beslan
רוג'יר	rogier
פראנשיסקו	francesco
פונסלה	poncelet
ראשומון	rashomon
פראנססקא	francesca
זאבין	zaven
צ'לנטאנו	celentano
שינג'י	shinji
דוריטש	đuric
גורשקוב	gorshkov
שאז	chazz
אמין	amin
קוסרי	cossery
אנא	ana
ראוייר	ravier
מויזאן	moizan
מידלר	midler
ג'אגדיו	jagdeo
ליסנר	lesnar
פונסיקא	fonseca
פאקיטי	facchetti
בולצמאן	boltzmann
ג'עפרגולי	jafargholi
זיב	zib
בוטו	bhutto
אילנה	ilana
שוטארו	showtaro
ספיד	speed
אדוארד	edward
גרזיגורז	grzegorz
גריגויר	gregoire
קומט	comte
יוהאנס	johannes
פיקולי	piccoli
נובטושי	nobutoshi
ויוריל	viorel
ראב	raab
דראזין	drazen
גאליטה	galite
דיב	dib
בנאיאהו	benayahu
גוינון	guenon
פאלמינטרי	palminteri
עדאנא	adana
בארניטא	barnetta
קונטי	conte
מיקלוס	miklos
קאפק	capek
קאפה	capet
דוקסא	doxa
ניקולודיס	nikoloudis
קאמיקאוא	kamikawa
קאטאלאני	catalani
דאנון	danon
מן	mann
נזאר	nazar
ואסילי	wassily
גאן	gann
פיזארו	pizarro
רוברטסון	robertson
טארטארוס	tartarus
באיר	baer
ריקארדו	ricardo
ליבנת	livnat
בוניק	boniek
ספיר	speer
מצפה	mitzpe
הנריק	henryk
ראיניא	rainea
קאטאלוניא	catalonia
ואסילי	vassily
דיקסון	dickson
הנריק	henrik
מיכאליק	michalik
ביאנקא	bianca
אליזא	eliza
קוראדו	corrado
באקלי	buckley
גאנדי	gandhi
קייסי	kasey
באלבוא	balboa
לווינסון	levinson
פרץ	peretz
אלבאירק	albayrak
פראסקו	frasco
אתנאסיוס	athanasius
ריזאל	rizal
הילנגר	hellinger
קוק	cook
מוקוינא	mokoena
סטילמאטש	stelmach
פריסק	frisk
אגוילאר	aguilar
יאגוצ'י	yaguchi
ויטמאן	wittmann
דזיקו	dzeko
דרבי	derby
מאקנאב	mcnab
ג'אסם	jasem
נאמיקאוא	namikawa
מיניונא	mignogna
פרודיוס	prudius
פוסי	fossey
ולטר	welter
טואל	twal
קונפיושוס	confucius
פרייר	freire
מירקוסור	mercosur
מלאלאי	malalai
גילרז	gillars
קאדילאק	cadillac
מיטאני	mitanni
פרנסוא	francois
אלאנור	eleanor
אנדריא	andrea
שבזי	shabazi
ניקלאס	niklas
זהוק	zhuk
רייבר	raver
נורתפילד	northfield
טאטלין	tatlin
מסיראטי	maserati
סטויצ'קוב	stoichkov
מאטילדא	matilda
מיט	mit
בארט	barthes
ואסילוסקי	wasilewski
ביט	bit
גולדינג	golding
טאלר	thaler
פיאטי	piatti
חאבייר	javier
פיטרוניו	petronio
ספיין	spain
דופונט	dupont
וודי	woody
פאנטיני	fanteni
דיסקברי	discovery
מורטי	morty
וולבו	volvo
קארקאר	karkar
נאסר	naser
פירוצ'יו	ferruccio
הנריקסן	henriksen
סירנאן	cernan
מורטי	morte
סמית	smith
מיטסואקי	mitsuaki
חיים	chaim
ויאזמא	vyazma
סוכו	sokho
קירשנר	kirshner
טאריק	tariq
סירז'	serzh
קינשאסא	kinshasa
משיר	meshir
פזה	fazah
מהנא	mehanna
ואניסא	vanessa
פופר	popper
לחאם	lahham
לאמבורגיני	lamborghini
מונארון	munaron
טארין	tarin
ליסינג	lessing
איב	yves
הארדין	hardin
טאריק	tarik
בריניאר	brynjar
ג'אסינטו	giacinto
שרית	sarit
ביליזל	belyzel
פאקסטן	paxton
הינמאן	henman
טאי	tie
ליובינקו	ljubinko
ורמילהינו	vermelhinho
פאטאגוניא	patagonia
גיורגי	giorgi
פילאדלפיא	philadelphia
לאי	lie
נאפוליטאנו	napolitano
חמאם	hmam
מאנויל	manuel
גאמביריני	gamberini
סארין	sarin
אמאם	emam
לורי	lori
מורי	mori
גירטרוד	gertrude
יושינו	yoshino
גאמסאכורדיא	gamsakhurdia
קייסי	casey
מירוסלאב	miroslav
אדורנו	adorno
באסל	basel
ואנהאנין	vanhanen
הליב	hleb
רשידי	rashidi
עמו	ammo
איראקליו	irakleio
סיד	cid
קושנר	kouchner
רולפו	rulfo
נוצ'ירינו	nocerino
אלילא	alela
וארגא	varga
נהריה	nahariya
ראינר	reiner
קופמאן	kaufmann
פראנסמאן	fransman
חאריס	haris
מאלפוי	malfoy
קאניפי	kanepi
ואלדיראמא	valderrama
בלאנק	blanc
לאזארו	lazaro
הולגוין	holguin
ג'וסטאין	jostein
מיגאלודון	megalodon
סטיפן	stephon
קאראבויה	karaboue
נורט	norte
סלבאדור	salvador
גרינאדא	grenada
דוניזיטי	donizetti
נורדין	nordin
נוג'ימא	nojima
בויוביטש	vujovic
תיס	thys
ואלון	valon
היאלמאר	hjalmar
אלאנד	aland
ארנסטו	ernesto
טסעדיט	tassadit
וירכויאנסק	verkhoyansk
חברון	hebron
דיאבלו	diablo
טומאני	toumani
בארוסו	barroso
אוסבורן	osborn
פאפוס	paphos
דונסקוי	donskoy
קאפילו	capello
ניזאם	nizam
קאטאניטש	katanec
קאסאנו	cassano
ניזאר	nizar
פוקוי	fukui
אלזהאימר	alzheimer
הוארטא	huerta
דאנסטאפל	dunstaple
קנדו	kendo
טסכינבאלי	tskhinvali
בנג'אמין	benjamin
מצגר	metzger
מארוין	marvin
באסטר	buster
דאסולט	dassault
מילטון	milton
דופלר	doppler
מפאי	mapai
פאיריטו	pairetto
חיסן	hissene
אוקומא	okuma
זאנגויל	zangwill
וינר	weiner
אלקנטארא	alcntara
מאריו	mario
מארין	marin
מקאלאני	mccallany
מארי	marie
טסאבט	tsabet
ביקלאנד	baekeland
סופוקליז	sophocles
מאריא	maria
גרומיקו	gromyko
יאקובו	yakubu
ראמסיי	ramsay
פוג'יא	foggia
פנקוסט	pancoast
מקאי	makaay
נוה	naveh
שיקמא	shikma
ז'ק	jacques
ענטר	antar
אליאהו	eliahu
קלארנס	clarence
פרוסט	proust
האיבין	haibin
בילין	beilin
קרים	karim
קארין	karin
קריסטיא	cristea
ליברון	lebron
בינידטו	benedetto
פלאג'	fallaj
מרזוק	marzouq
בלחוס	balhous
פוליטיקל	political
אסיק	asik
עקאד	akkad
מיסקיטו	miskito
פורסמאן	forssmann
שהזאד	shehzad
גבלה	jableh
אנג	ang
גוגינו	gugino
מאדונו	madono
טורו	toro
לוקאש	lukacs
גריגורי	gregory
צ'אלמי	chalme
סתרידא	sethrida
סטראנזל	stranzl
פלוה	flohe
קולומביא	columbia
בורגנין	borgnine
פלאטיני	platini
רוזאריו	rosario
שיריל	cheryl
טיטוב	titov
טיקליאנו	ticleanu
פורטאליזא	fortaleza
הוק	hooke
קארלסרוה	karlsruhe
לודיטי	lodetti
וילאן	whelan
דאנוב	danube
פאולינו	paulino
פלמחים	palmachim
דידייה	didier
קאימבי	kaimbi
פולגאר	polgar
הארסאני	harsanyi
באנגאלור	bangalore
ניקולא	nikola
מקארטני	mccartney
ביסאו	bissau
קירקילאס	kirkilas
טיופילו	teofilo
דג'יטי	djite
איתיל	ethel
טאסו	tasso
מאיר	maier
בויגיס	buigues
איבטיסאם	ibtisam
נאבין	naveen
שקלובסקי	shklovsky
המסון	hamsun
בארדון	bardon
סאדאת	sadat
דוכי	dokhi
אלפא	alfa
גאברילוב	gavrilov
סטולץ	stoltz
אסטוריאס	asturias
נקרומא	nkrumah
טאג'יקסטאן	tajikistan
וייטנאם	vietnam
ז'או	zhao
עוג'יילי	ojeili
גונאר	gunnar
דילידא	deledda
שאו	shao
קוליט	colette
דלוהי	dlouhy
מילשיוט	melchiot
נארונגצ'אי	narongchai
וידוקא	viduka
תורסט	thorst
אנדליס	endless
חנאוי	hanaoui
אלפרידו	alfredo
חמדאני	hamdani
סלאבקו	slavko
מאסאוע	massawa
ברוז	broz
ליבאנדובסקי	lewandowski
סאפין	safin
דאריו	dario
באבאקר	babacar
הוריזונטי	horizonte
אירית	irit
גייטסהיד	gateshead
באיומי	bayoumi
דומיניקא	dominika
מידנדורף	middendorf
האנסון	hansson
טאי	taye
קולונטאי	kollontai
סאפונארו	sapunaru
ריביליר	reveillere
קיי	kaye
באשילה	bachelet
יוסף	yossef
אלקסנדר	aleksandr
בק	bek
בת	beth
מארינא	marina
פיי	faye
סורנטינו	sorrentino
סיילז	sales
גוטלוב	gottlob
וינוגראד	winograd
הדר	hadar
בירגרין	berggren
האס	hasse
איסיק	issyk
וסנין	vesnin
האיאבוסא	hayabusa
באריטש	baric
קיריגאן	kerrigan
חאפז	hafiz
מוריסון	morrison
טראורי	traore
אלנבי	allenby
ויטור	vitor
חדאד	hadad
לוסיליו	lucilio
הארטמאן	hartman
זאקופאנא	zakopane
נום	gnome
האמונד	hammond
ריגובירטא	rigoberta
מונפיס	monfils
זקי	zeki
נאוקי	naoki
טופי	topi
ג'אמל	jamel
חפיד	hafid
וינסינט	vincente
נאוקו	naoko
פוטר	potter
שמיד	schmid
גיש	gish
לו	lowe
ברויר	breuer
פיסין	pisin
אלמאימני	almaimani
מונזא	monza
טיומקין	tiomkin
אנסילם	anselm
מרידור	meridor
מיקאיל	mikael
לאפטהאוס	lofthouse
קהווג'י	kahveci
באטיסטוטא	batistuta
הארולד	harold
סאלפיגידיס	salpigidis
חוסיין	husayn
פוקויאמא	fukuyama
בושימי	buscemi
הושינו	hoshino
טאהיר	tahir
מאסא	massa
פוטומאק	potomac
ערוץ	arutz
רוזנבאום	rosenbaum
חוסיינוב	khusainov
ליה	leah
טימור	timur
אלסנבאטי	elsonbaty
דונאטו	donato
בירנד	bernd
ברן	berne
דאגר	daguerre
גארבארק	garbarek
בירני	berni
לילא	leila
נאקאמורא	nakamura
פריד	farid
סאהין	sahin
חאריסטיאס	charisteas
רדא	redha
פאריס	faris
גליק	gleick
קאדאר	kadar
קיטון	keaton
לאקסנס	laxness
בונאנו	bonano
צ'לבי	chalabi
רוסי	rosi
דאנינוס	daninos
מיזוקי	mizuki
קיריל	kiril
יוקארי	yukari
האטא	hata
האשימוטו	hashimoto
אדוארדו	eduardo
חמידה	hmede
ואלטון	walton
פרנסיסקן	franciscan
ריצ'ארד	richard
קאדהירין	cadherin
מינסאה	mensah
ריסבירגן	rijsbergen
סקאילז	skiles
מידזוגורנו	mezzogiorno
מולנאר	molnar
האראדא	harada
פאמונגקאס	pamungkas
יושיו	yoshio
מיין	mein
נאין	nein
קלארקסון	clarkson
ויל	will
היל	hill
עאשור	ashour
יוסא	yusa
בהקט	behcet
ביל	bill
קיי	kei
זאקיר	zakir
פונטיין	fontaine
ליסטון	liston
יאסנורי	yasunori
פארק	park
ג'וליאט	juliette
סארק	sark
מוסא	musa
מייגו'ר	major
לו	low
מארק	mark
מוטא	motta
שוטוקאן	shotokan
קומפטון	compton
מאקליין	maclaine
מגיד	magid
קאסאס	casas
מוליגאן	mulligan
לאיוס	lajos
עבאסי	abbassi
באקארי	bakari
איסחאק	ishak
ספורזא	sforza
מוסיסילי	mosisili
פוט	foote
דודי	dodi
יאג'ימא	yajima
עמר	amr
קיטש	keach
וחיד	vahid
סימוביטש	simovic
מארולאנדא	marulanda
יאסמילא	jasmila
בודליר	baudelaire
פרידריק	frideric
חסנל	hassanal
חגי	hagai
דנבר	denver
דיאמונד	diamond
בעלבק	baalbek
מוגלין	moglen
ג'רמיין	jermain
בלו	belo
נאסיר	nasir
קובונטו	kubuntu
מאקאנגא	macanga
סאנטוס	santos
קאיסון	kaysone
דיסאיי	desailly
קיורא	kiyoura
גולמוחמדי	golmohammadi
בירטלז	birtles
וארן	warren
נאירובי	nairobi
באקשי	bakshi
זהבי	zahavi
רג'ולינא	rajoelina
סיטיגרופ	citigroup
בונדארינקו	bondarenko
דוגארי	dugarry
גינולא	ginola
קארטמאן	cartman
מאגנין	magnin
לאתאן	lathan
באנש	bunche
איוב	ayoob
סונו	sonu
ספנסר	spencer
בלקולה	belqola
ראמוס	ramos
קונסיסאו	conceicao
טאקיס	takis
מלבירג	mellberg
ביארן	bjarne
נוריאקי	noriaki
מוסלם	moslem
וודלי	woodley
בדר	badar
מאקסי	maxi
ג'אהין	jahin
ראמון	ramon
קורייר	corriere
יושיהירו	yoshihiro
קצרין	katzrin
איבא	eva
הייג	haig
קראוס	krauss
סידיו	sejdiu
סמאיסר	smicer
אלונזו	alonzo
אימז	eames
פאסדאר	pasdar
סוסיקי	soseki
עטרות	atarot
לולי	lule
קראוטש	crouch
אפוסטול	apostol
גבאגבו	gbagbo
דיילי	daley
צ'אטוין	chatwin
וארלאם	varlam
האגל	huggel
אינדיאן	indian
גאורג	georg
נאנאמי	nanami
סקוט	scot
חנדל	handal
דובאל	duvall
יאסין	yacine
דאריו	darijo
קאגאן	kagan
חורוס	horus
ליטבארסקי	littbarski
מחפוד	mahfoud
טאטארסטאן	tatarstan
פריץ	fritz
הרצליה	herzliya
רוקסאס	roxas
דיאב	diab
פול	paul
וידאל	vidal
קאנדר	kander
טרומאן	truman
סאווא	sawa
באלל	balel
לאנסבורי	lansbury
לינדפילד	lindfield
אקויטיין	aquitaine
פוטנאם	putnam
האינאן	hainan
בנטלי	bentley
אובסידיאן	obsidian
בארנול	barnaul
אנדריא	andria
טרושקן	troshkin
גילו	gillo
באלי	baley
היצ'קוק	hitchcock
קובאטש	kovac
דוג	dogg
מאסאקו	masako
לורימר	lorimer
זביהליק	svehlik
תרדסאק	therdsak
פאדל	faudel
שאמך	shamekh
בורנלי	burnley
לורקא	lorca
צ'או	chao
סאבין	sabin
באלמר	balmer
תיסן	thissen
ראספיוטין	rasputin
נורוז	nowruz
חאקים	hakim
לאנטוס	lantos
ליב	liv
וינדהוק	windhoek
ג'אקומו	giacomo
סירוטונין	serotonin
סטיפאן	stjepan
ארז	erez
לאנקסטר	lancaster
קרוסבי	crosby
סיסי	sese
אירינא	irina
לוסיוס	lucius
אחמד	ahmed
מערוף	maarouf
ואקים	wakim
חליקאן	khallikan
מיראלם	miralem
מונרו	munro
שלומי	shlomi
פגי	peggy
גיילן	galen
זאפאטיר	zapater
דביד	davide
שפרינצק	sprinzak
קיקוצ'י	kikuchi
אקונא	acuna
בג'אוי	bedjaoui
מאילז	miles
גראניט	granite
באראכא	baraja
לוקהד	lochhead
זוליק	zoellick
דיברא	debra
סילברסטאין	silverstein
רובאניאמי	rovaniemi
סארטר	sartre
בורוסיא	borussia
אלקיין	alkane
באהיא	bahia
זהרא	zahra
פארפاיט	parfait
סיביל	sybille
באזוקא	bazooka
וענונו	vanunu
טאקאיוקי	takayuki
בהיר	bahir
קמאראטונגא	kumaratunga
דאיהאטסו	daihatsu
קוריאן	korean
רומיין	romain
ראילי	riley
טושיו	toshio
פיסטון	fiston
אירוקויס	iroquois
רינר	renner
גרוב	grove
סקולא	scola
רום	rome
וומי	wome
סאגיסו	sagisu
נאטאלי	natalie
טריבור	trevor
לום	lome
מקסימוס	maximus
פיהר	fehr
ראמאמורתי	ramamurthy
ראגיב	raghib
בריגז	briggs
דרקוביטש	durkovic
פום	poom
רום	room
גמזטוב	gamzatov
נאנטס	nantes
גוטסמאנוב	gotsmanov
לוקין	luccin
נידאל	nidal
איורוספורט	eurosport
זאבארוב	zavarov
טרימורטי	trimurti
סלמאן	selman
ויקצ'יו	vecchio
מוגיהיטו	mugihito
חמיד	hameed
דמיטרי	dmitri
פארטיזאן	partizan
בינטו	bento
הילארי	hilary
קרוטו	kroto
ריצ'י	ricci
פולאק	polak
טובי	tobey
גורליץ	gorlitz
שיבא	sheba
סואזו	suazo
ביניטיז	benitez
לוקו	loko
דיסא	dissa
ואנקובר	vancouver
קאדישא	kadisha
יאנו	yano
טימור	timor
טריפולי	tripoli
סראפין	serafin
אנטאליא	antalya
סיסי	cisse
לורן	lauren
קאלאס	callas
מיסאוי	missaoui
זאלסקי	zalessky
מוניז	moniz
סארסגארד	sarsgaard
אנכבאיאר	enkhbayar
ריטוילד	rietveld
באלטימור	baltimore
קרייפורד	crayford
קיטס	keats
רינקויסט	rehnquist
אסאהארא	asahara
הייור	heioar
וזירי	vaziri
פינאר	pienaar
לינדר	linder
יולאנד	yolande
תורנטון	thornton
רג'א	raja
אליאנז	allianz
סאימון	simon
בוהארי	buhari
סטראוס	strauss
טומסלאב	tomislav
קאל	cal
ג'ודאר	jodar
טיבולי	tivoli
לופיסקו	lupescu
הנרייט	henriette
לורנס	laurens
מילנר	milner
טודנהופר	todenhofer
מאלי	mali
רימון	rimon
יואניס	ioannis
סיסלי	sisley
דאלי	dali
קיניאר	kinnear
קוסטוניקא	kostunica
ריטר	ritter
אתיין	ethane
מאסאמאסו	massamasso
קאסידי	cassidy
אליס	alice
קונין	konin
סוינטון	swinton
ביטאנקורט	betancourt
הונדוראס	honduras
לני	lenny
ארצי	artzi
מאלאטיסטא	malatesta
יוקי	yuki
ויסייר	veissiere
דידיקינד	dedekind
האמבולט	humboldt
ברודבנט	broadbent
סטיפאניא	stefania
מאטובינוביטש	matovinovic
דניזלי	denizli
טארי	tare
מיאנו	miyano
קנדהאר	kandahar
קארי	kare
קויסו	koiso
היספירידיס	hesperides
רומני	romney
רונית	ronit
אנטוניסקו	antonescu
קאפור	kafur
קאנדיד	candide
פיטאן	petain
שאוקי	shawki
ויראיודא	wirajuda
נורמאן	norman
וארק	wark
סטיפאן	stepan
ארמיניא	armenia
פאזלאגיטש	fazlagic
דורי	dory
אנטארקטיק	antarctic
טופיק	toufic
ולאדימיר	vladimir
מהרזאד	mehrzad
מסארי	msarri
ז'י	zhi
אמיל	emile
ריוקו	ryoko
שי	shi
פאפאס	papas
לויס	luis
רייסה	riise
נוקס	knox
ואסיו	wassiou
קאפו	kapo
האן	han
בראנקו	branko
בלום	blum
כהנא	kahana
טואפסי	tuapse
פאנדל	fandel
ציפי	tzipi
ליסיג	lessig
בריטיש	british
שמאך	chamakh
קארנאטאקא	karnataka
אראנגו	arango
קלקיליה	qalqilyah
לואל	lowell
קוטלר	kotler
טאקאיא	takaya
ניגאם	nigam
לימור	limor
גאלילאו	galileo
לוקס	luyckx
סורוס	soros
שינדלר	schindler
הייהאצ'ירו	heihachiro
קסורי	xuri
ראדאנוביטש	radanovic
סטראבינסקי	stravinsky
פיליפינז	philippines
שומיי	shumei
מיקיס	mikis
ניוקליטא	nicolita
עוואד	awad
ואנדרלי	vanderlei
מיקיו	mikio
אוטמאר	otmar
אבראג'	abraj
מיקולאס	mikulas
הולסט	holst
האישל	heichel
פטיראנודון	pteranodon
מוריס	maurice
מוראקאמי	murakami
מורירי	moriri
הארלסון	harrelson
פולי	polley
מוניב	moeneeb
אוסטיא	ossetia
דומיניק	domenech
טיג'אני	tijani
אוב	aube
קיוב	cube
סלאם	salam
קארי	kary
מרי	mary
פראניו	franjo
הארניק	harnik
ברנאר	bernard
קארי	cary
ג'ולייט	juliet
גוגנהאים	guggenheim
בוסאקא	busacca
פראנקו	franco
נסטור	nestor
הידי	headey
מכבי	maccabi
רוסודאן	rusudan
קינידי	kennedy
מיטסו	metsu
גרינט	grint
ויטאקר	whitaker
ג'ורג'יניו	jorginho
קאסאביטז	cassavetes
נונאקוסיין	nonacosane
ראמא	rama
לונג	lung
ואטו	watteau
טרטליאן	tertullian
אונג	aung
לאמא	lama
זויריב	xuereb
מאהלר	mahler
רוטארו	rotaru
קנטאקי	kentucky
קאראקלא	caracalla
פאמא	fama
נעים	naeim
בארוסו	barusso
פיליפוסיס	philippoussis
קוסמו	cosmo
חואילד	khuwaylid
פארדו	pardo
מורילו	morello
קאפיקי	capecchi
אלבין	albin
ולימיר	velimir
ויטוריו	vittorio
ג'וניצ'י	junichi
אריסטידיס	aristides
נאשף	nashef
תיודוראקיס	theodorakis
זביאד	zviad
פליטר	flitter
דאגאנו	dagano
קלימינז	clemens
ראדומיר	radomir
מולא	mula
קלאין	klein
לידרברג	lederberg
פורמאן	forman
קוזינקיביטש	kozynkevych
ראמיריז	ramirez
פטראס	petras
גוסלין	jocelyn
קימברלי	kimberly
דאני	dany
רינסניג	rensing
פן	penn
סוינסון	svensson
מאקאסא	makasa
פורסל	pourcel
ג'וחפיה	juhfiyah
נאהואטל	nahuatl
רייס	reyes
אסמהאן	asmahan
פליטיקוסא	pletikosa
חירז	hirz
מאלוני	maloney
מולא	mulla
ז'נג	zheng
ושתי	vashti
גילא	gila
טיטיקאקא	titicaca
מורסבי	moresby
גינגיטש	đinđic
נולאן	nolan
סאלומא	salomaa
פיטאר	petar
לובוס	ľubos
וילאזקיז	velazquez
הון	hon
ג'ון	jon
נוני	nonie
חירסון	kherson
מורוזיביטש	morozevich
דון	don
זרקא	zerka
קונגו	congo
פלורנטין	florentin
סוון	sven
אפרודאיטי	aphrodite
קל	kol
בריטאני	brittany
פאלמאס	palmas
דולינסקי	dolinsky
לאמפורוס	lampros
וימר	wimmer
סינגמאן	syngman
פאפה	pappe
שיארים	shearim
אמריקן	american
דאירו	dayro
קונץ	kuntz
זיבאלייביטש	zivaljevic
ירושלמי	yerushalmi
בונגו	bongo
גימריטש	gemmrich
סטודנט	student
סידורף	seedorf
ליסיצקי	lissitzky
פטוח	fattouh
הניה	haniyeh
אגיין	again
הירובומי	hirobumi
הריתיק	hrithik
טומוהירו	tomohiro
הירופומי	hirofumi
טאקאיאמא	takayama
סירוס	sirous
קואטימוק	cuauhtemoc
קאדר	kader
מיוצ'י	meucci
סלמא	selma
קולאק	colak
צ'אקויטאדזה	chakvetadze
מאו	mao
פינאילקיטונוריא	phenylketonuria
מאנגנאל	mangnall
סקוטלאנד	scotland
טוניטו	tonetto
פולינס	polleunis
רילמי	relmy
מרי	murray
גלאדסטון	gladstone
מילפומיני	melpomene
יוקו	yoko
לאיבנץ	leibniz
לוק	luke
מאריוט	mariot
האירודין	hairuddin
ברונסטין	bronstein
הוקו	hoko
סטוטש	stoch
רוצ'מבאק	rochemback
מארלבורו	marlborough
דארפור	darfur
רכמאנינוף	rachmaninoff
רייצ'ל	rachel
פאדו	fado
ג'ונתן	jonathan
עגנון	agnon
פאזרול	fazrul
עסקר	askar
פאולוס	paulus
פרס	peres
גרייזר	grazer
קומבין	combin
נאקאטא	nakata
זייטוני	zitouni
צ'אילדז	childs
פאירוז	fairuz
דאמארקוס	damarcus
סאראיוט	sarayoot
מאילז	myles
גאבורון	gaborone
ריטא	rita
טאג'ורא	tajura
מאקמילאן	macmillan
לאבון	labone
דיקנז	dickens
טאבי	tabi
ליטא	lita
ניטא	nita
דואי	dewey
ג'אבי	jabi
פלטולא	peltola
יורקשיר	yorkshire
גיטא	gita
טמים	temime
באבי	babi
ברנארדו	bernardo
מארדי	mardy
צ'אנוב	chanov
טטסו	tetsu
מיטיראן	mitterrand
בוב	bob
ע'גרם	ajram
אלפרד	alfred
ריבי	revie
פריון	prion
סטופארד	stoppard
פאסטור	pasteur
ראס	ras
קון	cohn
שראטון	sheraton
האנק	hank
טושיקי	toshiki
דרדיוק	derdiyok
הולמבוי	holmboe
טורונין	turunen
צ'ארלטון	charlton
לביב	lviv
קוזנטסובא	kuznetsova
חוסייני	husseini
קירק	kirk
סוליימאן	suleiman
שלאלא	shalala
קיסינג'ר	kissinger
ביגון	bigon
באקאלא	bakala
רשיד	rasheed
בוארק	buarque
יבנה	yavne
מנאמה	manama
סידריק	cedric
ליאמין	liamine
הגי	heggy
סאמר	summer
גארבוט	garbutt
סור	sur
קאברירא	cabrera
סומיל	sommeil
אוסאנו	osano
פאוליטא	pauleta
ג'עפרי	jaafari
צ'אנדריקא	chandrika
רודאן	rodin
קייס	kais
מאליק	malick
קלאס	klas
נורמאנדי	normandy
לוא	loa
בלאס	blas
מאנפרד	manfred
קנטאריא	kantaria
וויסלאב	vojislav
גוא	goa
סאנטי	santi
ז'באניא	zhvania
ג'האד	jehad
קורסיקא	corsica
צ'ו	cho
היוסטן	houston
בריט	brett
סריצ'קו	srecko
טויין	twain
לוקסמבורג	luxembourg
ניבזלין	nevzlin
לאמברטו	lamberto
האוארד	howard
סעודי	saudi
מאהש	mahesh
השאם	hesham
השרון	hasharon
חולוד	khouloud
זביריב	zverev
קוניו	cuneo
צוג'י	tsuji
טאקוני	tacconi
עזיזי	azizi
פיקסוטו	peixoto
בראקי	bracci
סולימאן	suliman
לובריטש	lovric
קונביי	convey
ינס	jens
רמז	remez
ברוקנר	bruckner
אטיאס	attias
לאנג	lange
גאלבין	galvin
אדלסטין	adelstein
מאטראי	matrai
איהארא	ihara
ווטרס	wouters
רוקי	rocchi
דילמוטי	delmotte
סייגו	seigo
יורי	urey
גריטא	greta
ג'ניאט	jenyat
בורדינסקי	burdenski
הארקוס	harkus
ואלדיר	valdir
ארדשיר	ardashir
גארגאנו	gargano
דיסאו	dessau
קראקסי	craxi
סאותאנד	southend
טרוסיה	troussier
מארינר	marriner
וינר	wiener
קולהוף	kollhoff
גאגו	gago
קארימבו	karembeu
רן	wren
לאזארוס	lazaros
חודייפה	hudhayfah
אלישע	elisha
חמד	hemed
אלמנבר	almenbar
אליסטא	elista
סוירי	sverre
האיטי	haiti
קוטארבא	kotarba
תיסין	thijssen
באכום	bakhoum
אלאבאמא	alabama
האנסן	hansen
הירמאן	hermann
בוטרוס	butrus
טאננבאום	tannenbaum
דאני	donnie
אירוין	irwin
חיאם	khayyam
טזוניס	tzonis
חסני	hasni
קינגסלי	kingsley
ג'ונינהו	juninho
היגל	heigl
הילגוסון	helguson
רוג	rogge
מארקוס	markus
ג'רקו	jerko
פפה	pepe
גריינג'ר	grainger
רינאט	renate
סקוילאצ'י	squillaci
סיוראן	cioran
בורסאטש	bursac
עקל	akl
קליבי	klibi
קנדא	canada
באנקסי	banksy
קאב	kav
זיאנב	zainab
טורקמאני	turkmani
גרינובל	grenoble
פטריטש	petric
מילג'ונא	miljoona
לוקהארט	lockhart
קאבנדיש	cavendish
ביאטריקס	beatrix
זילין	zelin
פליטשיר	fletcher
חזבון	hazboun
סאבילייטש	saveljic
נקאש	nakache
טאנג'ו	tanju
מאסני	masny
בודיקא	boudica
רחובות	rehovot
ניאתי	nyathi
ריבירא	rivera
שירלי	shirley
סו	suu
מאניטובא	manitoba
גוארניירי	guarneri
קרן	keren
פאטריק	patrik
מאגדיבורג	magdeburg
גאטוסו	gattuso
רוד	rod
גארד	garde
נודיא	nodia
מאקון	makoun
דינאנט	dinant
ג'ונקויט	jonquet
אסטרו	astro
קאבריטא	cabrita
גינריך	genrikh
עוסייראן	osseiran
מהדאוויקיא	mahdavikia
לי	leigh
סאנג'ו	sanjo
גיהאן	gehan
בוניטו	bonetto
ג'אנקארלו	giancarlo
קורנל	kornel
סאלביאטי	salviati
קאמאמוטו	kamamoto
בגדאדי	baghdadi
נארינדרא	narendra
גירנזי	guernsey
קופי	coffi
שון	xun
הירויוקי	hiroyuki
גולדבלום	goldblum
אוהארא	ohara
זבאניטש	zbanic
סון	sun
קיריניא	kyrenia
קודריא	codrea
לוקאשינקו	lukashenko
דודיק	dodik
טראפאטוני	trapattoni
לוקאס	loukas
ג'ובאיר	jubayr
קאריס	charis
גרינבירג	greenberg
צ'ארלז	charles
מאדלין	madeleine
פיזשיק	piszczek
קלינגר	klinger
גאריב	gharib
אירן	irne
יעקוב	yaqub
אלעלואני	alalwani
דייביז	davies
זוי	zoi
ברומלי	bromley
קויד	quidde
ארני	arne
ג'יגורו	jigoro
קאלדר	calder
נימיטש	nemec
ג'וסיבא	joseba
אולימפוס	olympus
בובאן	boban
נימאן	neeman
אטלטיקו	atletico
נאלבאנדיאן	nalbandian
סיזיר	cesaire
טרינידאד	trinidad
צ'פיטה	chepita
ג'ובאני	giovanni
לארטר	larter
פידלר	fiedler
האסנקליבר	hasenclever
חאלד	khaled
רינו	rino
דילייטא	dileita
קרוזר	kreuzer
הינו	hino
ראמאטי	rahmati
נינו	nino
באלדור	baldur
ווס	woese
רוד	ruud
ג'ינו	gino
עמאד	emad
עאדל	adel
בקארי	bacary
נואדיבו	nouadhibou
גמליאל	gamliel
פיינטון	painton
אלבחרי	albahri
גיגאקס	gygax
פוליזי	puglisi
רייק	reik
יוקון	yukon
רוראימא	roraima
קלימוב	klimov
סלים	selim
מאתיו	matthew
לורינזו	lorenzo
קינאן	kenan
הילגא	helga
ליפי	lippi
סאניא	sagna
הילג	helge
גסאן	ghassan
קליפטון	clifton
מארקיטא	marketa
קריצ'וביאק	krychowiak
דילון	dillon
דילי	dili
מהדי	mahdi
גילי	gili
אולגה	olga
ראי	rai
צ'ינגי	chingy
בקי	becky
הינדרי	hendrie
האי	hai
גריקטינג	grichting
מאי	mai
סטאבאנג'ר	stavanger
באי	bai
פיגוי	peguy
פלויסטי	ploiesti
גבריאל	gabriel
ברוקי	brocchi
פיין	paine
קאליכא	calleja
שלאים	shlaim
פיניקס	phoenix
נורברט	norbert
רוטלאנד	rutland
קינמוצ'י	kinmochi
רינאלדז	reynolds
פיר	pire
מאלטא	malta
אדלמאן	adelman
ירקוני	yarkoni
מיקרומטר	micrometre
ואלדיז	valdez
מאקדאול	macdowell
דיאבייט	diabate
קאלימירו	calimero
קיסוקה	keisuke
דאיר	dire
סאדלר	sadler
גאודי	gaudi
ליברמאן	liebermann
פפאנקוטש	pfannkuch
פוסטיגא	postiga
בהטאש	behtash
ספייסי	spacey
אתלטיק	athletic
ריוצ'	rioch
הארי	harry
אלברט	elbert
לאנדגרין	lundgren
אנאסטייז'ה	anastasia
מיצ'יאר	meciar
דראידן	dryden
קירון	kieron
נובוסוקה	nobusuke
קליפט	clift
פידריטי	pedretti
מקפאדין	mcfadden
קיראן	kieran
טורבין	torben
בינוא	benoit
מאסאיושי	masayoshi
פאיק	pike
הולאנד	holland
האידלברג	heidelberg
גאגארין	gagarin
הילינגדון	hillingdon
מילאני	melanie
קאבל	cabel
גוסן	ghosn
פלורנס	florence
וילקינז	wilkins
טומסון	thomson
קודרו	queudrue
זאקארי	zachary
פיית	faith
גילון	gillon
פאקונדו	facundo
יוסוף	yusuf
מאטסוו	matsuo
מאגנו	magno
ניס	nice
קולייס	coulais
סיינט	saint
לאמונט	lamont
רמלה	ramla
טורקו	turku
אבאלון	avalon
גאלבריית	galbraith
פיון	fillon
אורלוב	orlov
קאסטילו	castillo
מונק	munch
רוטאן	rutan
שוקלי	shockley
סרגון	sargon
רוצ'יטו	rocheteau
טירינס	terrence
פינא	pena
פינינפארינא	pininfarina
רינא	rena
אבונייט	ebonite
לבייב	leviev
מוריטא	morita
גלין	glynn
גונג	gong
לארי	larry
אליקסיי	alexei
אורהאן	orhan
חוסין	hossein
עיסאטי	aissati
פוסטינו	faustino
קירשן	kirschen
סינא	cena
סלאבין	slaven
מצה	matza
ניסיפור	nicephore
מינונגו	minoungou
ברוכין	brukhin
אדולף	adolph
דיאו	diao
פרלמאן	perelman
טריפל	triple
גראף	graf
פלין	flynn
מיסטראל	mistral
האניסקו	hanescu
גינגיני	genghini
יהודא	yehuda
באלבו	balbo
צ'אמאנגא	chamanga
הראוי	hrawi
סיגולין	segolene
ואלטרז	walters
נאטסומה	natsume
אוסאמה	osama
סודרבירג	soderberg
פרידי	freddy
הימא	hima
באנג'ו	banjo
פייטון	peyton
רובסון	robeson
אספאראגין	asparagine
דויל	doyle
דימא	dima
סטילר	stiller
גאנדולפיני	gandolfini
ארקולאנו	ercolano
ליוביסיטש	ljubicic
ראוחי	rawhi
קארפינקו	karpenko
פלאהירטי	flaherty
קורטני	courteney
גו'טלאנד	jutland
רותבארד	rothbard
ולאסוב	vlasov
טומר	tumer
פרדינאנדו	ferdinando
שאוקי	shawqi
טראבזון	trabzon
טאל	tal
ראנדי	randy
ואל	val
האל	hal
קאל	kal
לאל	lal
מושארף	musharraf
האבאנא	havana
באל	bal
אטנא	etna
נימולר	niemoller
טינסינג	tenzing
טארק	tarek
באלטא	balta
סומר	sumer
קאתי	kathy
ריקילמי	riquelme
יליניק	jelinek
קארמן	carmen
פורטוין	fortuyn
איזהאר	izhar
יוליא	yulia
מילדריד	mildred
פאסולקו	pasulko
מיינז	mainz
טורבו	turbo
ריטו	reto
רומר	rumer
דיג'אן	dejan
רוביקון	rubicon
אלטו	aalto
ויסלי	vesely
ליטו	leto
פרונייה	prunier
מיין	maine
הות	huth
מינרבא	minerva
טורנהאם	turnham
אידאהו	idaho
קאפר	kafr
דיליטש	delic
בויאני	boiany
מאנספילד	mansfield
אנדרז	anders
בוגאטי	bugatti
קוך	koch
לוך	loch
קורבן	korban
שאה	shah
טשילר	chyler
ויומינג	wyoming
דוקומון	ducommun
קארין	karren
ספרא	safra
פירארי	ferrary
נירודא	neruda
פרי	peri
ספרי	safri
סרי	seri
ג'אנין	janine
משהור	mashhur
סרטאווי	sartawi
קינשין	kenshin
מיליבא	mileva
גוס	guus
נירי	neri
קאסאנובא	casanova
קאמילו	camillo
זאיון	zion
ויליאמס	williams
קארה	carre
ידיד	yedid
כיסופים	kissufim
שיוזאוא	shiozawa
ספילינג	spelling
שוארצניגר	schwarzenegger
לאץ	lutz
בולאחרוז	boulahrouz
בטינו	bettino
חוג'ייג'	hojeij
פאסטרנאק	pasternak
האמבורג	hamburg
קבאסנאק	kvasnak
האנט	hunt
רולאנד	rowland
קאבריני	cabrini
קוניהיקו	kunihiko
דבאס	debbas
קבה	kebe
חאג'י	hadji
בארו	barro
יוקיקו	yukiko
פארקור	parkour
לאבון	lavon
פארמאן	farman
ליבני	livni
מרווחין	marwahin
מוחמד	mohamed
האירדאל	heyerdahl
צ'אנסא	chansa
קוסוקי	kosuke
ברימה	brehme
סרגסיאן	sargsyan
קונילי	connelly
דאמיאן	damien
אירלנדא	ireland
ואליריו	valerio
ניל	neal
באנקאריל	bancarel
ארטור	artur
פתחי	fathi
עידו	eido
סטרייט	strait
סאדק	sadeq
איבראהים	ibrahim
יובא	yuba
סוהראב	sohrab
מונטילא	montella
טקפיריה	takfiri
גירשוין	gershwin
פאטריסיו	patricio
זיידאן	zeidan
טוסון	tusun
וונלאנתן	vonlanthen
דוסלדורף	dusseldorf
נאראזאקי	narazaki
סאדק	sadek
אליסון	allyson
האנסון	hanson
פיליקס	felix
ג'אקמאן	jackman
יאקובליב	yakovlev
תקוה	tikva
רונד	ronde
פאסקאל	pascale
לותאר	lothar
גארי	garry
טיבי	tibi
זוף	zoff
אלאן	allan
קאבידס	kaviedes
גריקו	greco
ביבי	bibi
יאו	yao
ראצ'אד	rachad
הארטפילד	hartfield
פורטשן	fortune
יוליהראטש	ulihrach
ראלף	ralph
סאו	sao
מדוור	medawar
בראנדל	brundle
הנדריק	hendrik
האו	hao
אבטובאז	avtovaz
פאנוס	fanous
גיקיל	gicquel
גרנדונא	grondona
לייטון	leyton
אינוס	enos
קאו	cao
דאו	dao
פינק	pink
דורון	doron
בלגראד	belgrade
וינק	vink
סו	sowe
מאנמוהאן	manmohan
גיזינגא	gizenga
קרבינקובסקי	crvenkovski
די	dis
מאלקין	malkin
כנען	kanaan
רידג'וול	ridgewell
רינקון	rincon
סאריונאנדיא	sarrionandia
מארקיאן	marcian
פולטון	fulton
בארון	barron
מימירנג	memering
פאיר	fire
קאביל	cavell
מאנסון	manson
ברונליסקי	brunelleschi
איביזא	ibiza
סעדי	saadi
איזמיר	izmir
ריבילא	rivilla
סאפינה	safina
חלילהודזיטש	halilhodzic
באטאיסק	bataysk
הירוקי	hiroki
בראנסון	branson
טאיניו	tainio
סורטיס	surtees
ור	wehr
שאצ'נר	schachner
חמיס	khamees
שוארmמן	schwartzman
ניטוליקא	netolicka
קאטאלינסקי	katalinski
סטאילאיטס	stylites
סקארפא	scarpa
בולארד	bullard
מוראטי	moratti
אולמו	oulmou
לוטשר	loetscher
טוגנדהאט	tugendhat
חילו	hilu
אלסנהורי	elsanhuri
ורמונט	vermont
ביאטריס	beatrice
נוסטראדאמוס	nostradamus
ואקאמוטו	wakamoto
אסאמוא	asamoah
דאבור	davor
ארמין	armin
הורילהו	heurelho
אגריפא	agrippa
נקאש	naqqash
הארט	hart
הארדי	hardy
קואלוסקי	kowalewski
קויאמאדא	koyamada
גאסקוני	gascony
בארט	bart
הינד	hind
דלוז	deleuze
מונד	monde
וסטמינסטר	westminster
נור	nuur
אדן	adan
האקיקאר	hakikar
רוברט	robert
קוטוקו	kotoku
חלוץ	halutz
תירינג	thiering
שאמכאני	shamkhani
טוטי	totti
נדאדאי	ndadaye
סולים	sulim
זבונאריבא	zvonareva
ניצה	nitza
הוקאידו	hokkaido
רוזאנא	rossana
מנדוזא	mendoza
איזאבל	isabelle
קונדו	kondo
צ'אנדלר	chandler
שיפר	schiffer
סטיפאן	stephane
גאסקוין	gascoigne
רג'פ	rexhep
דיטרויט	detroit
רדא	reda
קאסיאנוב	kasyanov
מיריו	meyrieu
נרנסט	nernst
נוואס	nuwas
בעל	baal
נדא	neda
בידא	beda
טוקילאו	tokelau
היראקליון	heraklion
נישיקורי	nishikori
קריסטיאן	cristian
נאנסן	nansen
דאלמיישא	dalmatia
צ'יפוליני	cipollini
ג'סיקא	jessica
ריקובא	recoba
סאותהאמפטון	southampton
סירקן	sirkin
וילאנד	wiland
פיגו	figo
מארדי	mardi
סטאלינג	stalling
שוטלר	schuttler
שינינגאיאמוי	shiningayamwe
זקארדו	zaccardo
פיקיט	pickett
מורינו	moreno
ואלירי	valeriy
ראדקליף	radcliffe
בילהארץ	bilharz
ריקא	rica
דירבורן	dearborn
שימבורסקא	szymborska
זאנג	zang
וירהיין	verheyen
סילדראירס	seeldrayers
מונוז	munoz
זאראגוזא	zaragoza
גאבריאל	gabriele
דיקא	dica
בין	bin
אסטוניא	estonia
סוסומו	susumu
מונקאיו	moncayo
ריוטארו	ryotaro
נונדא	nonda
ואוטרוט	vautrot
ויל	weill
מיורא	miura
שיר	cher
זיו	ziv
טאפאריל	taffarel
לוגאנו	lugano
איבאנוביטש	ivanovic
אטאטורק	ataturk
איראד	irad
רומאנו	romano
ויו	viv
בלקאן	balkan
מוראבצ'יק	moravcik
גריבאוסקאיטי	grybauskaite
ריסר	risser
ניב	niv
ויאלי	viale
טאוב	taub
האמרפיסט	hammerfest
מריאח	meriah
מוריטייניא	mauritania
אנדראניק	andranik
טימלין	timlin
נישימורא	nishimura
שובל	shoval
נסיבאמבי	nsibambi
קראבילי	caravelli
איפאניי	ifeanyi
בויל	boyle
שיברדנאדזה	shevardnadze
ג'רמיין	jermaine
לאנס	lance
קאראדינז	karadeniz
פירוסיני	perusini
מירסיא	mircea
מארתא	martha
אראי	arae
האיאמי	hayami
ברונר	brunner
קולפאקס	colfax
ארשאבין	arshavin
לידין	leiden
קאצורא	katsura
סודאן	sudan
גאידוסיק	gajdůsek
גרינגראס	greengrass
וסטינגהאוס	westinghouse
קאטי	cutty
דאריוש	dariusz
אלמורשיד	almurshid
לוסיאנו	luciano
וילאסקיז	velasquez
אופנהימר	oppenheimer
מאנוליטי	manolete
טירנר	turner
סארה	sarah
זוהר	zuhr
רישטר	richter
אנדריי	andrey
לנון	lennon
פפלוגלר	pflugler
יאנוש	janusz
יאקוט	yaqut
בילאיא	belaya
נסטוריוס	nestorius
סימין	simin
יוליו	julio
מאטו	mato
הופמאן	hofmann
מיטסומאסא	mitsumasa
אולימפיא	olimpia
באוור	bauer
דרי	dre
אליזאבת	elisabeth
סטריסמאן	stresemann
רימאן	riemann
קאלמאן	kalman
ראמאיאנא	ramayana
ליגוריא	liguria
גזא	geza
איראולא	iraola
סטיב	steve
תירופודא	theropoda
גוירירו	guerreiro
מיי	mey
ניי	ney
דוליטל	dolittle
דובינסקי	dubinski
ביי	bey
האמל	hammill
דיי	dey
מקניל	mcneil
ימאני	yamani
שאריט	sharett
ואורינקא	wawrinka
חוסיין	husain
לאקסומבורגו	luxemburgo
דמיטרי	dmitry
נאנבודו	nanbudo
אוין	owen
ורזאזאת	ouarzazate
ברגסון	bergson
קאטויסא	katowice
קארדו	cardo
רונאלדינהו	ronaldinho
פולקנר	faulkner
פרידל	friedel
גשר	gesher
ניידין	nadine
היליניק	hellenic
מגא	mega
מאצולא	mazzola
מדריד	madrid
פאדל	fadl
גריזים	gerizim
בירגומי	bergomi
סטאל	stahl
מודי	mudi
פיוטר	piotr
סודי	soddy
מידבידיב	medvedev
דוטש	deutsche
מאגי	maggie
היברט	hibbert
יורק	yorke
טיטו	tito
עלודי	alloudi
טורקיש	turkish
טאראבט	taarabt
קאסטוניר	castonier
באסל	bassel
פולין	pauline
קונקורד	concorde
צוקמאיר	zuckmayer
רויטמאן	roitman
טאקיו	takeo
סידקי	sidqi
בוגאלו	bugalo
פיזו	fizeau
מאראט	marat
טירזאנידיס	terzanidis
פיוטר	pyotr
אילן	ilan
חאדר	khader
נדיקומאנא	ndikumana
הירושימא	hiroshima
לינקולן	lincoln
מאריאנא	mariana
אנריק	enric
קוזמאן	quzman
ארנסט	ernst
ספאקס	sfax
סטיל	still
טנג	teng
זיידון	zaydun
שאמס	shams
מאקסויל	maxwell
מארגרט	margarete
לויסאו	luisao
טורינג	turing
סידריק	cedrick
ויניק	weinek
בלחאג'	belhadj
דינג	deng
פנג	feng
פילגוי	pilguy
זרוק	zarruq
ויאלי	vialli
גוג'ונסון	guojohnsen
דין	deen
ישארי	jashari
שאנון	shannon
פוטיטו	potito
קאראן	karan
מוריאנטס	morientes
פראדיש	pradesh
קרבוניק	carbonic
איזאק	isaac
ג'ודה	judah
פודגוריקא	podgorica
מיטריבילי	metreveli
באסינגר	basinger
סאמאנתא	samantha
קאמלוט	camelot
אלדאודי	daoudi
ג'ורג	jorg
שוקי	shawky
הארון	harun
אלסיקילי	alsiqilli
ג'לויד	jlloyd
טנריף	tenerife
הידיקוטי	hidegkuti
קרימר	kremer
מארצ'לו	marcello
מאליק	malik
טוויל	tawil
בהראם	bahram
פראנקלין	franklyn
בראקסטון	braxton
קאתירין	catherine
גואנגהו	guanghu
אמברוס	ambrose
סקסטון	sexton
קאלה	calais
מקרם	makram
אבנר	avner
מואי	mwai
פופא	popa
קארניגליא	carniglia
מאטסודא	matsuda
טמסמאני	temsamani
טרינטינו	trentino
פיונגיאנג	pyongyang
ליפשיץ	lipchitz
לאטוף	latuff
לימאן	liman
קופא	kopa
הסטר	hester
ג'וזף	jozef
דוליים	dulaim
קארדינוסא	cardenosa
קופא	copa
נאכבאר	nachbar
מיכיל	micheľ
בוברניק	bubernik
קלירי	cleary
סקארמיטא	skarmeta
טקלה	tekle
לאיונינג	liaoning
סאטורו	satoru
דלברוק	delbruck
גאליאני	galliani
סימפירופול	simferopol
אלשהיד	alshahid
הרצל	herzl
אנטבה	entebbe
קאבאנא	cavanna
גאיגראן	ghayeghran
קאמיא	kamiya
סולארי	solari
מאסליונקן	maslyonkin
פאלופ	palop
דוומוה	dwomoh
יוהנא	johanna
ברטראנד	bertrand
בייה	beye
דידריק	diderik
שאובו	shaobo
ויליגאס	villegas
גודפרי	godfrey
סולאנו	solano
דרעא	daraa
אלאנסארי	alansari
שעראוי	shaarawi
טובא	tuva
גתה	goethe
סוכומי	sukhumi
ג'אד	judd
הוג'ו	hojo
קאטרמול	cattermole
גראס	grass
בורגניטש	burgnich
קאזאנצאקיס	kazantzakis
נאזם	nazem
עפלק	aflaq
מוריזיו	maurizio
רים	rem
אבני	avni
האידי	heidi
חורדאו	jordao
לם	lem
בולזאנו	bolzano
הוכל	huchel
בודאן	budan
הילארי	hillary
היקארו	hikaru
גפן	geffen
ארון	arun
בראון	braun
טאנקיאן	tankian
מירטון	merton
גרון	grun
ברק	barak
דאוד	dawoud
סומטרה	sumatra
סטיליאן	stiliyan
גרימסון	grimsson
ניפלהאים	niflheim
מודיסטי	modeste
ואסקי	waske
בייבל	bejbl
עוסמאן	osman
לארנקא	larnaca
ניקלאס	niclas
דגניה	degania
לא	la
ורסינגיטוריקס	vercingetorix
הובארט	hobart
בא	ba
אקסון	exxon
ליל	lil
פיאטרא	piatra
אויל	oil
מוהאג'ראני	mohajerani
ילוסטון	yellowstone
גיל	gil
דודה	daudet
בויטא	vojta
אלבארי	albari
גוין	gwen
סימוניטש	simunic
לילהאמר	lillehammer
יירזי	jerzy
קובלאי	kublai
גאלזוורתי	galsworthy
הידאלגו	hidalgo
פאקיטו	pakito
באריזי	baresi
פארמא	parma
אדריאנא	adriana
מאוס	mauss
נסאר	nassar
הייני	haney
ורמס	vermes
סוכא	socha
פאזיקאס	fazekas
גאראי	garay
נאור	naor
קיטיסאק	kittisak
דיץ	dietz
קארני	carney
מיראן	miran
זינקו	zenko
דוג	doug
פארח	farah
פרג'	faraj
סחר	sahar
ליליאן	lilian
ג'פרי	jeffrey
אגאתא	agatha
רוש	roche
טורונטו	toronto
בוכארסט	bucharest
טולוז	toulouse
פאראג	farag
מחמוד	mahmud
סחאב	sahab
פאר	par
גודוינסון	godwinson
נאומאן	naumann
דודו	dudu
נילסון	nilsson
לאמארי	lamari
חורין	khoren
טודור	tudor
פיקיון	piquionne
מיקל	mikkel
קריסטאנבאל	christanval
רוזא	rosa
באבאקאן	babacan
ויזיק	vizek
קיראן	kiran
ג'נר	jenner
קאנו	kanu
ג'ומו	jomo
אימאר	aimar
הילדיטש	hilditch
גוגל	google
ריצ'י	ritchie
מאנה	manet
פומפיו	pompeu
סיף	seif
אקיהיטו	akihito
בייקר	baker
בנחסי	benhassi
אלחמאדי	alhamadi
מאניע	manea
ספינא	spina
זאכאראיא	zachariah
קלאודיא	claudia
יויצ'י	yuichi
אלעשי	elachi
בונייר	bonaire
טירול	tyrol
ג'יורגוס	giorgos
האריס	harris
בינהאקר	beenhakker
בולטמאן	bultmann
מונטגומרי	montgomery
קליבר	kleiber
קלאיסטרז	clijsters
קוסטינהא	costinha
אפרון	efron
סילי	sealy
חאג'ים	hajim
שומפיטר	schumpeter
קיניצ'י	kenichi
באסיל	basile
אסטי	asti
באסילא	bassila
בילוזוגלו	belozoglu
אסטי	esti
מאלו	malot
דימבא	demba
שריר	sharir
סטיפנסן	stephenson
ג'וליון	joleon
מוחטארי	mokhtari
סופיא	sophia
ג'אניז	janez
ליגרוטאלי	legrottaglie
סאטושי	satoshi
יוניסקו	unesco
טאקיוצ'י	takeuchi
גריניט	grenet
מאטסוקא	matsuoka
ינאי	yanai
ריגיירו	regueiro
טירוסין	tyrosine
שוקיירי	shukeiri
קאזימיר	kazimir
דאיאן	dianne
צ'ובאניטש	chovanec
קקי	kakhi
צ'יבו	chivu
טסויושי	tsuyoshi
אוסואלד	oswald
וונדר	wonder
דארבי	darby
נסטרוב	nesterov
מחל	mahal
קאלו	kalou
מאריאנו	mariano
ואקסמאן	waksman
מירבו	mirbeau
האלי	halley
הירו	hiro
ריו	rio
בלקאס	belqas
מורדור	mordor
אוסטראליא	australia
אלחנן	elhanan
דיילי	dailly
קטע	kata
לחד	lahad
נאמבארין	nambaryn
מוסימיטש	musemic
וליקו	veliko
ג'אלו	jaloo
אימליי	imlay
הרנדל	hurndall
מונטירו	montero
רידניק	rednic
קול	cole
האין	heintje
ג'וטשי	jochi
הינקל	hinkel
פוסי	fauci
ברונו	bruno
ריוקיצ'י	ryokichi
לאמנס	lammens
אני	annie
פורמאן	foreman
פרידה	frida
סטיاנר	steiner
מקמאהון	mcmahon
לודזא	ludza
סרדיניא	sardinia
ג'האן	jahan
טילמאן	tillman
בסט	best
היונדאי	hyundai
ביראק	birak
טיראסיל	teerasil
נדאו	ndao
טוג'ו	tojo
פנאק	pennac
מאסארו	masaru
הירוהיטו	hirohito
הורי	hori
תמים	tamim
שלי	shelley
מקלאקלאן	mclachlan
לויזיאנא	louisiana
ספינס	spence
לוי	levy
קאראקאס	caracas
חמדאן	hamdan
קורי	cori
סמיר	samir
גארבו	garbo
לילי	lily
ניקסון	nixon
ואלדיס	valdis
דיינס	danes
חמיס	khamis
נאנינגא	nanninga
קרוגר	krueger
ואלדז	valdes
בירנולי	bernoulli
סמיח	samih
ניקולה	nicolet
אמיליו	emilio
בגדאד	baghdad
אקאקי	akaki
בוש	bosch
ניקולא	nicola
פומיהיקו	fumihiko
פורסקאל	forsskal
ג'יימז	james
כרמי	karmi
יאונדי	yaounde
נחל	nahal
ראמין	ramin
יאכור	yakhour
טרטוס	tartus
מאנטל	mantell
סונגול	songul
באניל	banel
גויסדון	guesdon
הייסרר	heisserer
טומוט	tommot
וילנדר	wilander
הרץ	hertz
פורוש	porush
שאגארי	shagari
מוחמדו	muhammadu
סיל	seale
אונקין	oncken
מאטיאס	matias
בראדברי	bradbury
אוקאפור	okafor
קאייבוט	caillebotte
פכנר	fechner
חמיט	hamit
דהב	dahab
מזרחי	mizrahi
פיראס	firas
נילסן	nielsen
קוריגאן	corrigan
רופרט	rupert
חמיד	hamid
באייסטא	ballesta
רוסו	rousseau
בונסאי	bonsai
קיין	caine
דג'וקוביטש	djokovic
גוטהילף	gotthelf
מורטאלא	murtala
מארקוני	marconi
נבראסקא	nebraska
פיסקאטור	piscator
דילייני	delaney
לין	lynne
דומיניקא	dominica
קריפן	crippen
סארקוזי	sarkozy
גאניא	ganea
טירני	tierney
בוגאנדא	buganda
קונאקרי	conakry
אשר	asher
גולד	gould
באדאלונא	badalona
חמידו	hamidou
באיקי	bikey
טחיה	taheyya
בחר	bahar
מרים	meriem
טאיטוס	titus
קאלקוטא	calcutta
סוטנר	suttner
ג'ונסטון	johnston
בנימין	binyamin
זטקין	zetkin
סאיאקא	sayaka
מאקגינס	mcguinness
עקרור	akrour
מאטאדי	matadi
מל	mel
סקולי	sculli
טלפאח	talfah
ליליאן	lillian
קאנסו	qanso
ג'אקוב	jakub
לופ	lupe
האידרוגראפיק	hydrographic
באוהאוס	bauhaus
גווארא	guevara
גיטוליו	getulio
מונטיניגרו	montenegro
דרידא	derrida
ראבשאן	ravshan
טולסטוי	tolstoy
ראדיק	radek
לוקויל	lukoil
דיי	day
פלאסיל	plasil
מאברוס	mavros
גרד	gerd
בירקלי	berkley
לאמיא	lamia
ביניסון	benenson
קאראסו	carrasso
הוסאי	houssay
פוירוס	foiros
טוסקאני	tuscany
מיהאלי	mihaly
קורבר	corver
פירוקסיקאם	piroxicam
נועם	noam
האנקוק	hancock
קאמל	kamil
ג'חש	jahsh
הלמוט	helmut
אורלינז	orleans
מארסיאנו	marciano
פיליפס	phillips
פאו	phau
שאטילי	shatili
אברהם	avraham
גונטר	gunter
היידן	haden
ג'ראנימו	geronimo
אברהם	abraham
דאוד	dawood
ויטולד	witold
פולר	fuller
ג'ולי	julie
קירשניר	kirchner
פהד	fahad
ג'יימי	jamie
סאנא	sanaa
גרייס	grace
קומו	como
מנשה	menashe
יאנקולובסקי	jankulovski
היוברט	hubert
ג'אואד	jawad
קאבאזאשבלי	kavazashvili
קרוטיקוב	krutikov
דואיט	dwight
סלימאן	sulayman
קאניטו	kaneto
פריז	friz
מיטש	mitch
גוסטאב	gustave
זקאת	zakat
דיבינדרא	devendra
סוליימן	sulaiman
אודנסי	odense
פיל	peel
קאמדן	camden
דזודזואשבילי	dzodzuashvili
ואלק	valke
פירוצי	peruzzi
באשי	bashi
דיוניסיוס	dionysius
לופוליאנסקי	lupolianski
אוסלו	oslo
טיילור	taylor
קוקי	koki
שיפארד	shepherd
בלאזיי	blazej
עבאן	abane
מיאקי	miyake
נאמי	namie
בורבאקי	bourbaki
סטיפאן	stefan
ג'יהאי	jihai
איתן	eitan
סבארו	sbarro
מקדורמאנד	mcdormand
שון	sean
האפל	happel
פאניול	pagnol
סורין	sorin
חנאן	hanan
קואריסמא	quaresma
אשלי	ashley
ג'ין	jean
קולומבוס	columbus
לין	lean
זיזי	zeezee
דאפי	duffy
יושימוטו	yoshimoto
וינאלדא	wynalda
בודארט	bodart
ואסיל	vasyl
ג'ארדל	jardel
ויליאם	william
סוצ'ופאריק	suchoparek
עזיזו	azizou
קאראמנליס	karamanlis
זורין	zorin
פארירא	parreira
קוקא	kuka
לוקא	luka
גילסנקירשן	gelsenkirchen
בווא	bois
נאתאניאל	nathaniel
קאוזיו	causio
מאקסים	maksim
גראם	graeme
מיטשל	mitchel
פיונטיק	piontek
בילי	billie
סויוז	soyuz
קייט	kate
מאטי	mate
סלובודאן	slobodan
סיביל	seville
ניהאט	nihat
דוסן	dawson
קאטי	cate
מומסילו	momcilo
קילד	kjeld
בינה	binet
קאהנמאן	kahneman
סטאנקוביטש	stankovic
יויצ'ירו	yoichiro
קלאיפידא	klaipeda
בארבירא	barbera
טאקאנו	takano
טדמור	tadmor
בארברא	barbara
לואנדא	luanda
דאיקי	daiki
ליב	leib
בקר	bakar
טורילי	torelli
עמק	emek
סטאן	stan
סאמבורא	sambora
סאלאנדרא	salandra
חמוש	hamouche
זואגי	zouagi
זוס	zuse
אינסולין	insulin
ליפיליר	lepiller
מאריסקא	maresca
באמיר	bamir
טוגאשי	togashi
פארו	paro
שאוקאט	shaukat
קרוננברג	cronenberg
זאק	zack
מינטאל	mental
אורויל	orwell
באלמונט	balmont
דג'בו	djvu
קונסטאנטינו	konstantinou
פורטמאן	portman
ראגח	rageh
גונוהיו	gonnohyoe
עאמיר	aamir
סמבוסק	sambusac
קאונטי	county
איופאן	iofan
מאלקו	malko
גלין	glenn
מאמורו	mamoru
עבדאן	abadan
ניידר	nader
אוגוסטא	augusta
פראטי	prati
מאלייז'א	malaysia
גאסיד	gassid
חמוד	hamoud
מונטיריי	monterrey
ויינא	vienna
סונג	song
טונג	tong
וונג	wong
הונג	hong
לונג	long
גרטי	gerty
יוסי	yossi
מחמודי	mahmudi
גמיל	gamil
האגן	hagen
בלאטר	blatter
ביחאר	bihar
פיזיי	pezzey
אפגאני	afghani
מארשאל	marshall
סמאחה	samaha
אנדרסן	andresen
מוראדי	moradi
לינז	linz
וליד	waleed
רותשילד	rothschild
ניירא	neira
רובינסטין	rubinstein
באסטן	basten
מקאן	mccann
מארמאדוק	marmaduke
רינזו	renzo
גאבראס	gavras
טימבקטו	timbuktu
ראבוסיס	ravousis
גארדר	gaarder
מוריאל	muriel
אולסן	olsson
סאבא	saba
מונטיסורי	montessori
דיקוב	dickov
לולא	lola
נורדיסק	nordisk
ג'מאל	cemal
יוטירפי	euterpe
פיסטוני	pistone
רוני	roni
ג'וני	johnny
טוני	toni
גלן	glen
גולד	gold
וול	wole
האתאיראטאנאקול	hathairattanakool
עודאי	oday
זינגן	zengin
ריבו	ribot
אקיוטיפוליא	acutifolia
טמבלנד	timbaland
מינאסה	menasse
באדר	bader
הידן	hiden
הידיו	hideo
הינז	henze
חמאדי	hammadi
בורובודור	borobudur
צ'יסלנקו	chislenko
פאלרמו	palermo
אוקאמוטו	okamoto
אריסטיזאבאל	aristizabal
ספאם	spam
חולוסי	hulusi
סינדרילא	cinderella
באלאבאן	balaban
גאלימזיאן	galimzyan
סטיוארט	stuart
מנשביק	menshevik
ואיט	white
קאבוט	cabot
אכמיטילי	akhmeteli
סינאן	sinan
סאינאי	sinai
קלאסניטש	klasnic
רינת	rinat
טוריומי	toriumi
מאטיאס	mattias
נאיקסט	nyquist
פיאף	piaf
סימוז	simoes
קוסטאנזו	costanzo
ליפסטדאט	lipstadt
אליגרי	alegre
בורכיס	borges
דמפסי	dempsey
מאריק	maric
אוזיל	ozil
סולימאן	souleymane
מינגי	mingyi
רואני	rouani
הראנט	hrant
בילל	billel
קאמפוס	campos
קאלון	kallon
טימושינקו	timoshenko
מאנואלא	manuela
אום	umm
קיווס	kiwus
ראדוסיו	raducioiu
צ'אביז	chavez
לאריא	laryea
טאים	taim
חיים	haim
דארדין	dardenne
לזיון	lezion
דורדיביטש	đorđevic
נאפליון	napoleon
בירנארט	beernaert
האסי	haase
הלק	hulk
נוהייר	nohair
רוטסון	rotson
מיטניק	mitnick
טאקאנורי	takanori
קאקו	kaku
טאקאמורי	takamori
בינידיקטין	benedictine
באקו	baku
ריפלי	ripley
פיטוראט	piturat
רי	ri
סאי	si
באבא	baba
יעקב	yakov
פאלין	palin
אנטונינו	antonino
גוידו	guido
מורין	morin
הילי	hiele
קלאוס	klaus
פלדמאן	feldman
גאבור	gabor
קארובי	karroubi
ריבולי	rivoli
אוריגון	oregon
יורק	york
ג'ורג'	jorge
ואסילי	vasily
סדרא	sadra
פירסי	percy
נאבאר	navarre
רון	ron
קוטי	coty
קורניליא	cornelia
סיסלא	ciesla
קאסטאנו	castano
בודיאניסקי	budyanskiy
קורניל	cornell
הילט	helt
האלדור	halldor
לאמפארד	lampard
פוסקאס	puskas
עמוס	amos
מינאר	minar
זוקו	zoco
דונאדוני	donadoni
שידיאק	chidiac
מיזונו	mizuno
ברגותי	barghouti
דוטרי	daughtry
תיודוסיוס	theodosius
מאנדריבא	mandriva
מאסי	masi
קאליקסיקו	calexico
אלווין	alvin
נזאמי	nezami
לוקו	loco
דייויס	davis
קרית	kiryat
ג'אלמא	djalma
בוקו	boco
קוקו	coco
וישנו	vishnu
גוסטאב	gustav
סטייסי	stacy
שאצקיך	shatskikh
סאמפסון	sampson
דיאז	diaz
קרישנא	krishna
נאקאו	nakao
יוריס	joris
סיגפריד	siegfried
צ'יבא	chiba
גולאם	ghulam
בוכהולץ	buchholz
ארס	ars
מחתופי	mahdoufi
קאסם	qassem
קנאן	kinan
תור	thor
סוביט	subait
פוד	fode
קורילי	corelli
ריגנסברג	regensburg
בידל	beadle
מילקא	milka
סטראיסאנד	streisand
חאשוגי	khashoggi
קריסטיאן	christian
האסלר	haßler
סקאנדינאביא	scandinavia
בולטירא	volterra
קאמילו	camilo
ג'וביאן	jovian
מארסיל	marcell
גוראני	gorani
מאטסקאזי	matsukaze
זאפאטירו	zapatero
סעדי	sadi
קרוז	cruz
ריבאז	revaz
נובויוקי	nobuyuki
קוזמא	kozma
בנימין	benyamin
מאטסוזאוא	matsuzawa
פאדי	fadi
ג'וי	joey
ארטא	arta
האמפטון	hampton
נוריו	norio
מרכז	merkaz
גרימאלדי	grimaldi
פישלר	fischler
ריפעט	rifaat
קומראן	qumran
אלביס	elvis
עשראוי	ashrawi
ברסלין	breslin
פאסאנסקי	pasanski
טרוקווסקי	trochowski
מושב	moshav
רוברידו	robredo
בריטון	breton
יורופ	europe
סיקולאראק	sekularac
בירליוז	berlioz
חידיאטולין	khidiyatullin
קורטז	kurtz
איזרילז	israels
האנובר	hanover
קיטאנו	kitano
איסטבאן	istvan
גאזאניגא	gazzaniga
קלאוס	claus
סופיא	sofia
רוסי	rossi
ריסין	ricin
דאונינג	downing
באנאטין	bannatyne
לוב	love
בוקא	boca
קוריא	correa
דורין	dorin
הליל	halil
מאטסוקאטא	matsukata
קורזון	curzon
סאנדור	sandor
קימפף	kempff
דוריס	doris
טיראספול	tiraspol
ליברט	lebert
פירוסיטש	perusic
עאטף	atef
בירוסוס	berossus
לאנסאנא	lansana
חלדון	khaldun
סטיפאנופולוס	stephanopoulos
האמילטון	hamilton
קוריא	coria
סנוע	sanu
פלאמיון	flamion
קורין	corin
דומיניקו	domenico
קריסטין	kristin
מאנו	manu
ג'אסינטו	jacinto
איראן	iran
בטרון	batroun
תוקידידיז	thucydides
ליסלי	leslie
גותאלס	goethals
שינא	chynna
פראן	fran
מוסעב	mosab
דימושאקי	dimoschaki
ליונה	lyonnais
מובלי	mobley
אהוד	ehud
נאגאלאנד	nagaland
בלאזיק	blazek
בוריס	boris
פורטלאנד	portland
נאי	nighy
מוראיאמא	murayama
ניקולאי	nikolai
טיטאנו	titano
קאבילא	kabila
אריטריא	eritrea
לויס	louis
לאזארוס	lazarus
פטרוס	petrus
סאנטאמארינא	santamarina
אראנא	arana
שרלוק	sherlock
בוליטיירי	bollettieri
טאונו	tauno
ניות	neot
מארלין	marlene
יונלונג	yunlong
שפר	schefer
חירות	herut
יולדוש	yo‘ldosh
פידל	fidel
פטרוס	petros
תונגלאו	thonglao
זאמפיר	zamfir
קויס	kouis
לביא	lavi
בוסיס	bossis
ג'ינאס	jenas
פיינציל	paintsil
איגאראשי	igarashi
באבאיארו	babayaro
מוראנדי	morandi
קרויישה	croatia
מוריאק	mauriac
פולנד	poland
סלים	saleem
רייגן	reagan
צ'ילדיריק	childeric
אוהרלאו	uhrlau
רביקא	rebecca
פראנקי	frankie
שויטשי	shuichi
מאטי	mati
אתוס	athos
באדו	badou
גראנד	grand
דאטי	dati
זיביטש	zebec
ניקולאי	nikolay
טרוטסקי	trotsky
סוקסומקיט	suksomkit
ראטס	rats
באנדאראנאיקה	bandaranaike
נאיג'ל	nigel
גראנט	grant
מאטס	mats
פראנק	frank
אולימפיק	olympic
פינידי	finidi
יהוד	yehud
מחמדו	mahamadou
מארמאריס	marmaris
קוריקיו	korekiyo
מארטצ'לו	marcelo
עבדאללה	abdallah
קוריול	couriol
פראנס	frans
בואינג	boeing
מארקוס	marcos
האגי	hagi
רודריגו	rodrigo
לנגלן	lenglen
בירזוט	bearzot
נאגי	nagi
קונוסוקה	konosuke
מיקהיו	mchugh
לו	lou
נו	nou
ירון	yaron
קאלגארי	calgary
ולצ'ק	vlcek
רידנאפ	redknapp
הונדרטוואסר	hundertwasser
עוזייר	ozer
אייזנר	eisner
אנגיל	anghel
גאנדאם	gundam
ערקטינגי	aractingi
ג'ילאלי	djilali
דהאם	daham
קיפר	kiefer
איברי	ivri
ג'ק	jack
בנגלאדש	bangladesh
סטראדיבאריוס	stradivarius
בנס	benes
פאטרסון	paterson
דראמאני	dramani
הוברט	hubbert
בולר	voller
האשי	hashi
פנינה	pnina
מארקיס	marques
טאסוטי	tassotti
מארקוס	marcus
עאד	ade
קאריל	carrel
ליוויראני	liverani
ג'אקלין	jacqueline
בארסילאטא	barcelata
מאצ'אלא	macala
אורל	aurel
קודרו	kudrow
גוטליב	gottlieb
ויטל	whittle
ריצ'ארדסון	richardson
נורינא	noreena
ויאן	weian
טירינס	terence
מרברוק	marbrook
ג'אסים	jassim
קריספוס	crispus
מאקורמיק	mccormick
נלסון	nelson
בורו	boru
מנא	mena
ראידר	ryder
פאילו	filo
רוקו	rocco
פוקאהונטאס	pocahontas
האידן	haydn
מוריהירו	morihiro
נאנדור	nandor
סנאידר	snyder
ספריוי	sefrioui
ליופארדי	leopardi
אנאטול	anatol
פורטוגסי	portoghesi
קולהאס	koolhaas
פירסי	persie
צ'אפמאן	chapman
הלמהולץ	helmholtz
טומו	tomou
בולוני	boloni
נישיקאוא	nishikawa
קוסובו	kosovo
ברגמאן	bergmann
לרמנטוב	lermontov
דילסון	delson
קודג'א	codjia
סטרוסנר	stroessner
וירקירק	verkerk
ואיס	weiss
ואסיג'	waseige
סטיקלנבירג	stekelenburg
נאסים	nassim
זיקלון	zyklon
קומפאורי	compaore
טינאן	tynan
פויול	puyol
בירנאנקי	bernanke
פיטר	peter
ראסמוס	rasmus
מויני	mweene
אלגיפארי	alghifari
ברקאט	barakat
קיבאקי	kibaki
ספאפא	safafa
אורנים	oranim
וורדיקרז	voordeckers
חולון	holon
יוסטאס	ustase
סודברי	sudbury
וויצק	wojcik
זאהורסקי	zahorski
פאז	paz
ראז	raz
ראמי	ramy
סאמי	samy
באיקונור	baikonur
דארסיס	darcis
היטסלפירגר	hitzlsperger
קלוראמפיניקול	chloramphenicol
אישיהארא	ishihara
לאמי	lamy
עזיז	aziz
טיגילס	teugels
לימוטשיא	lemmouchia
דינקליג'	dinklage
טירי	terry
קאורי	kaori
אנקא	anka
צביטאן	tzvetan
שמיר	shamir
בראיזאט	braizat
לאזאר	lazare
טאטיאנא	tatyana
גויאנא	guyana
זוייל	zewail
סיאנא	sienna
ברנו	brno
סטיפאן	stephan
בחר	bahr
ברזוצקי	berezutski
עאמל	amel
קלוג	klug
רוי	ruy
קאתרין	katherine
אמיטב	amitav
סזוליק	szulik
דומיטיאן	domitian
קרזינוויק	krzynowek
אינונו	inonu
בסאם	bassam
מולטאטולי	multatuli
ארמיא	armia
באי	buy
באסים	bassim
גאי	guy
ברוסנאן	brosnan
ג'האנגיר	jahangir
פאולא	paola
אמסאעד	imsaad
פידרסן	pedersen
ג'ארו	jarreau
אילהאם	ilham
פאולי	paoli
קאסיריו	chasseriau
פאולו	paolo
קלינגופר	klinghoffer
ספינוזא	spinoza
מאקינון	mackinnon
מג'די	majdi
עוסמאן	ousmane
פינקלסטאין	finkelstein
גרובר	grover
גורבאן	ghorban
רות	ruth
ראאד	raed
סוראיא	soraia
פפין	pepin
מורגן	morgan
גרילפארצר	grillparzer
ברודריק	broderick
סטופאר	stupar
מאמאדו	mamadou
מיגרון	migron
ראזאנו	razzano
הלאל	helal
מולדובאן	moldovan
ג'וסלין	jocelyne
פאלמירו	palmiro
אנגלאנד	england
אליק	alec
טאיט	tite
לאריונדא	larrionda
ליביד	lebed
מאיט	mite
דאניאלא	daniela
לושאן	lushan
יאזד	yazd
סימיונוב	semyonov
מנדיריס	menderes
בייל	bale
דייל	dale
גרונמייר	gronemeyer
פרידי	freddie
ראדו	radu
ואילז	wiles
קאנצ'לסקיס	kanchelskis
קאלאנגא	kalanga
פראיס	price
מיודראג	miodrag
פאטימה	fatima
בריסביין	brisbane
בדו	badu
שדיד	chadid
קירי	carrie
מג'ד	majed
ואשינגטן	washington
בראדיסקו	bradesco
פולי	foley
סליבו	sljivo
דואדא	daouda
פוטוק	potok
קייגו	keigo
קומאן	koeman
בורניו	borneo
מירקל	merkel
באשו	basho
קינגו	kengo
מירו	miro
קאסונדי	kasonde
סטויקיטא	stoichita
שילבי	shelby
צ'ירו	ciro
שלי	shelly
רמייש	rmaich
מאמידאלי	mammedaly
סארפיי	sarpei
סימפסונז	simpsons
נודלמאן	nudelman
עבדו	abdoh
ספירופולוס	spiropoulos
גארגולא	gargula
וילש	welsh
סלובאק	slovak
עבדו	abdou
מוחטאר	mokhtar
אלעאידי	alaidy
בויאדין	vujadin
זוברבוהלר	zuberbuhler
בטיר	battir
סאיפי	saifi
קונישי	konishi
חנאניא	hanania
אובלאסט	oblast
סימונז	simons
האמאן	hamann
דאוה	dawa
ביידא	bayda
ג'אקמוט	jacmot
מוראנו	murano
חמדי	hamdy
אטלאנטיס	atlantis
גולדמאן	goldman
שילפא	shilpa
טראיס	trice
גונארסון	gunnarsson
ז'יניו	zhenyu
שרוט	shroot
חמדי	hamdi
סיבאסטיאנו	sebastiano
שילא	shilla
ג'אוואד	javad
שוייצר	schweitzer
בולאנד	boland
מריאם	merieme
דולביקו	dulbecco
הולייה	houllier
וילטורד	wiltord
פלוטארך	plutarch
פיראוס	piraeus
בליון	bellion
סקאלסקי	skalski
אנא	anna
בוחירד	bouhired
נורמי	nurmi
סקובלאר	skoblar
יונאיטד	united
מאריאן	maryan
סוקריסטוב	sukristov
זרמאט	zermatt
יונאן	yunnan
ספאלאנזאני	spallanzani
ליברמאן	lieberman
וירון	veron
בראין	bryan
חיפה	haifa
גיביט	givet
פאליטא	paletta
בלאנקינסטאין	blankenstein
קאטסינא	katsina
פלוטז	ploetz
מקימסון	mckimson
קרויף	cruyff
האנסן	hanssen
מארטן	maarten
מירון	meron
נוקיא	nokia
נורסולטאן	nursultan
נואנקו	nwankwo
קישו	kisho
קישי	kishi
האניו	hanyu
סקולז	scholes
ריה	rie
יאן	yan
נוסבאום	nussbaum
לירוי	leroy
מומטאז	mumtaz
קיגאן	keegan
דוירטי	doherty
היראקאוא	hirakawa
קארגיל	cargill
רידלי	ridley
קולודין	kolodin
בובקר	boubacar
רובנסון	robinson
נאן	nan
סופיאן	sofyan
דן	dan
פאן	fan
פראדיק	fradique
טיימפו	tiempo
אלקסנדר	alexandre
אלקסנדרא	alexandra
פוליאנא	pollyanna
סאיף	saif
חנא	hanna
אימולא	imola
ליבצ'נקו	levchenko
אלפידא	alfida
צ'ן	chen
הארטמוט	hartmut
מנגלה	mengele
רוגובא	rugova
רונאלד	ronald
ג'ייסי	jaycee
ג'פירסון	jefferson
טונטון	tonton
ריבסט	rivest
קרוג	krogh
מיבו	mevo
באטמאן	batman
קארולוס	karolos
אינטו	into
סטאניסלו	stanislaw
פוקי	foeke
סטאנסילאס	stanislas
עלייב	aliyev
פיולא	piola
קופלאנד	copeland
קאיפו	kaifu
ענאבי	annabi
דניס	denis
גאלר	galler
דיקאן	decane
סטאר	starr
יון	yun
מוטראן	mutran
וירא	vera
בוסניטש	bosnich
סורבון	sorbonne
קויבאס	cuevas
מומנז	mommens
סאמרז	summers
סיריליק	cyrillic
זאיטלין	zeitlin
טריסטאן	tristan
קאסילי	caselli
טובאלו	tuvalu
ליונוב	leonov
סינאמואנג	senamuang
סורינאם	suriname
אלסקאן	alaskan
קאיפנג	kaifeng
בנין	benin
האלברסטאם	halberstam
דימיטריס	dimitris
ריינדירס	reinders
לינז	lenz
בנז	benz
מיגאבאיט	megabyte
ג'אנסן	janssen
סטפאנסון	stefanson
יאנג	yang
זינו	zeno
לוינתאל	lowenthal
קואמי	kwame
אנדרוניקוס	andronicus
סילסו	celso
אמיון	amioun
אוקטאן	octane
יורי	uri
בסייסו	bseiso
טאקאיושי	takayoshi
אקסטרא	xtra
שובייר	shobair
מאטיאס	matyas
פקרון	fakroun
סאריוגלו	sarioglu
שהאב	chehab
רוד	rudd
חורקיירא	jorquera
בישה	bisha
פרימורסקו	primorsko
אנדריי	andrei
מאהאליא	mahalia
וריזאס	vryzas
מיראנדא	miranda
ליסטראד	lestrade
קאנדינסקי	kandinsky
באלדי	balde
רוזנטאל	rosenthal
הארלו	harlow
ברמודא	bermuda
לומברוסו	lombroso
מזלום	mazloum
גאנג'ז	ganges
באליג	baligh
סקלטון	skelton
טורקי	turki
אוקילו	okello
סירטיטש	sertic
שומאכר	schumacher
פינין	fenin
האנס	hanns
דארון	daron
דארום	darom
קאיטיסוק	kiatisuk
פליסיס	plessis
האני	hanni
מוסא	moussa
מוטויאמא	motoyama
דיבא	diba
בוקאי	bucaille
סדיק	sedik
בוניט	bonnet
סידי	sidi
ג'ייקובס	jacobs
ענאבטא	anabta
מוליס	mullis
מהאבהאראטא	mahabharata
מאיאקובסקי	mayakovsky
דניס	dennis
סחנון	sahnoun
מאנהאטן	manhattan
בוטינאנט	butenandt
דירק	dirk
מוצארט	mozart
צ'יקליס	chiklis
טראביס	travis
אסטראדא	estrada
צ'ורדא	chorda
עבייד	ebeid
גאסאמא	gassama
דאלמאט	dalmat
קריסטוף	christophe
קורסי	curci
היוסטן	huston
ראיקונן	raikkonen
בורונין	voronin
קאראסקו	carrasco
נור	nour
בניס	bennis
דאנא	danna
אורסון	orson
דיטר	dieter
קאהלו	kahlo
קריק	crick
אלדו	aldo
וודביל	woodville
אבריטאניא	evrytania
ניסון	neeson
קאנא	canna
קאיזרסלאוטרן	kaiserslautern
פילם	film
נوניהו	netanyahu
ויולא	viola
פרוגיריא	progeria
דוב	dov
טרוסירו	trossero
באירו	bayrou
טראפאלגאר	trafalgar
ברודסקי	brodsky
קארל	karl
דינו	dinu
מאסאקאזו	masakazu
שופנהאור	schopenhauer
ווטקה	wuttke
באנדיראס	banderas
דרנובסיק	drnovsek
קאנו	kanno
קונסטאנטינוס	konstantinos
משהראוי	masharawi
ממפיס	memphis
מודריטש	modric
טומי	tommy
דואלא	douala
אולימפיאד	olympiad
הארגריבז	hargreaves
הוביי	hubei
שאבאני	shabani
מוראביא	moravia
נוולז	knowles
סיאמסול	syamsul
מאמיקו	mamiko
בריסטול	bristol
באטיסטון	battiston
ראסל	russel
גארי	gary
ניטרא	nitra
מונד	mond
רקס	rex
סיריל	cyril
טיקס	tex
סיסטו	sisto
אבל	abel
אליסון	ellison
גרייב	ghraib
יאשין	yashin
מידילין	medellin
לאקור	lacour
קלתום	kulthum
מקטירנאן	mctiernan
מורדכי	mordechai
סודרבירג	soderbergh
דאלאס	dallas
וילדרז	wilders
טצ'אנגאי	tchangai
הרצוג	herzog
ריסטו	risto
גיבי	givi
מאיקי	mikey
מורטאז	murtaz
נורדאל	nordahl
מאקגראו	mcgraw
ארסלאן	arslan
טאזמייניא	tasmania
טריג	treg
הילל	hillel
ראיאן	ryan
ספוטניק	sputnik
תיאגו	thiago
ג'אסטן	justin
סמילינג	semmeling
חיטין	hittin
נאקשוואני	nakshawani
גריג	greg
מנארי	mnari
קומאנצ'י	comaneci
יורי	yuriy
סוטי	sutee
נוסימבאום	nussimbaum
טוריאמא	toriyama
סטשון	schon
מאסימו	massimo
אמסטרדאם	amsterdam
לובלין	lublin
ליהמאן	lehmann
זינדן	zenden
טונסי	tounsi
סאיטו	saito
דיסמונד	desmond
קארדוצ'י	carducci
פונידילניק	ponedelnik
סטיבנס	stevens
אפגנסיטאן	afghanistan
קלינסמאן	klinsmann
שמاדהובר	schmidhuber
גריגור	gregor
ניקולאו	nikolaou
מורוזוב	morozov
טאמרא	tamra
ארקא	arca
קואדוו	kwadwo
יאמאזאקי	yamazaki
קוייד	quaid
ג'וג'ירו	jujiro
דאני	danni
ג'יג'י	gigi
ניני	nene
פאד	pad
בני	bene
עובייד	obeid
מוסטגאנמי	mosteghanemi
דיפו	defoe
ג'אד	jad
פריי	frei
דאני	danny
בארטולי	bartoli
דאן	dunn
טאימוראז	teimuraz
קראיטשק	krajicek
בד	bad
מוניר	mounir
אירין	irene
גד	gad
ארדיליס	ardiles
מולאן	mulan
סנטורק	senturk
היק	hick
פירמאני	firmani
שאראנסקי	sharansky
מומו	mommu
רוהר	rohr
גאלאס	gallas
מוניר	munir
מירידא	merida
באראנקוס	barrancos
אליטיס	elytis
ג'ונין	junnin
לוהר	lohr
בשיר	bachir
גורניאק	gorniak
עסאף	asaf
נילו	nelo
ואלדייר	valdeir
קאפליצ'ני	kaplychnyi
שיף	schiff
קירטיז	kertesz
ביגוניו	bigogno
וילנאי	vilnai
גוגלילמו	guglielmo
קינגסון	kingson
יארוסלאב	jaroslav
בונירא	bonera
קאמפוש	kampusch
קאופמאן	kaufman
בדואן	bidouane
ערביד	arbid
צ'אראלאמבוס	charalambos
סקאליא	scalia
מנצ'ו	menchu
ארביל	arbil
פירארא	ferrara
סאוט	sawt
באגאיוקו	bagayoko
יורדי	jordi
בראמירץ	brammertz
אונטייריו	ontario
ניקו	niko
קוסימוב	qosimov
קאקונג'י	kakonje
רוסו	russo
זוראוסקי	zurawski
לאטונג'י	latoundji
ארהארד	erhard
פיאנו	piano
פאסארילא	passarella
חלף	khalaf
מולוד	mouloud
סינתיא	cynthia
בארברא	barbra
בורד	burd
פיטשינינו	piccinino
דבלין	dublin
גראציאני	graziani
אוסטין	austin
גיליספי	gillespie
בהג'א	bahja
דיארא	diarra
מאטיובסקי	matejovsky
נאוטאקי	naotake
היראנומא	hiranuma
גריזלוב	gryzlov
פאני	fanny
שטיפי	steffi
מיגלית	megalith
ליגיא	legia
שריברז	schrijvers
פאלקינמאיר	falkenmayer
מסטיסלאב	mstislav
נפר	knepper
סיבירינו	severino
אירטון	ayrton
אטווד	atwood
סוסקינד	suskind
צבאיג	zweig
אמוניום	ammonium
יואב	yoav
בובר	buber
ליז	liz
ספומאטו	sfumato
מקאבוי	mcavoy
לוביט	lovett
ק.	c.
נארימן	narimene
בניטי	benetti
גוטסקוב	gutzkow
טושיהידה	toshihide
ברוניל	brunel
הולאגו	hulagu
טוניגאוא	tonegawa
אורטיגא	ortega
צ'נגיז	chinghiz
אדיגיא	adygea
סולר	soler
הוריישיו	horatio
אגוירו	aguero
שקודר	shkoder
פאטריק	patrick
ויליט	villette
קריסטיאן	christiaan
עאפיה	afia
קובאד	qubad
נוטינגהאם	nottingham
לוסינהוף	lussenhoff
ג'ף	jeff
קפלר	kepler
סאנטילאנה	santillana
טרייסי	tracy
חוסני	hosny
יופ	jupp
חוסייני	hosseini
קטגורי	category
סאקאשבילי	saakashvili
קואן	quan
בארבוסא	barbosa
סואן	suan
חוסני	hosni
ג'ופ	joop
חואן	juan
קואן	kuan
סאמבא	samba
דלאוור	delaware
פאסקו	pasco
פוליקליטוס	polykleitos
בורלוג	borlaug
גרופיוס	gropius
יאקוטסק	yakutsk
וינטורי	venturi
אורינוקו	orinoco
אנילקא	anelka
זיין	zein
אקונקאגוא	aconcagua
טינקו	tenco
זונדרבאן	zondervan
זאהוביטש	zahovic
בייני	beynie
פיינורד	feyenoord
חמרוש	hamrouche
דרייק	drake
הירושיגה	hiroshige
יוסטינוב	ustinov
קרוצ'י	croce
סולטאן	sultan
פידיריקו	federico
נידום	nedum
קאטשינסקי	kaczynski
קרוקי	croci
סיטשב	sychev
רויטר	reuter
מודנה	modena
דראמאן	dramane
בוהלין	bohlin
אסלאן	aslan
לויינדולא	luyindula
שון	shawn
אבוגאדרו	avogadro
טינטוריטו	tintoretto
אספיריטו	espirito
טיומין	tyumen
פישר	fischer
היסילינק	hesselink
ברוק	brock
קורטיס	cortes
ואלנטי	valente
בארדם	bardem
סאנדובאל	sandoval
זורו	zorro
קאסטרו	castro
פריגה	frege
קהלאני	kahalani
דראזן	drazan
רימי	remi
סאומיל	saumel
נוסרטי	nosrati
זקריא	zakariya
ויאני	viani
הואינא	huayna
בקאטי	bakkati
ויאנא	viana
גראנד	grande
בגין	begin
עסאם	issam
רושיל	rochelle
מיסכי	meskhi
שאדי	shady
פילופוניז	peloponnese
טוד	todd
טיניאן	tinian
טירסן	tiersen
מועין	muin
לאקויסטא	lacuesta
וויסיטש	wojciech
שוברט	schubert
בולא	bola
שוסאקו	shusaku
טוראנדוט	turandot
ואלדיביא	valdivia
ריברי	ribery
קאראגוניס	karagounis
קאטשר	kutcher
גות	goth
סטאנישב	stanishev
ג'ורג'ו	giorgio
נסיר	naseer
נגאטג'זיקו	ngatjizeko
גויראני	guirane
ריציטילי	rizzitelli
דודי	doody
גיבלי	gibli
רשיד	rachid
פאסקואל	pascual
ליאן	liane
יאסר	yasser
איבאנובו	ivanovo
פלאטג'יס	plaatjies
מקסים	maxim
ג'אודאט	jawdat
קאסאבלאנקא	casablanca
לאמאר	lamar
מוריס	morris
רוברטס	roberts
איסילקול	isilkul
הוניס	hoeneß
אלסמני	elsamni
מירקיור	mercure
פיטרוסיאן	petrosian
מונזינגר	munzinger
חדשיטי	hadchiti
נדלובו	ndlovu
אלג'לדאקי	aljaldaki
אנדריי	andre
סוינקא	soyinka
מאג'וריל	majorelle
הילברט	hilbert
בורקע	burqa
מקראקין	mccracken
ג'יאנג	jiang
ג'בוטנסקי	jabotinsky
בורשארדט	borchardt
מולבי	molby
הירונימוס	hieronymus
טיגאנא	tigana
הולדין	holden
קושניר	koechner
פארסונס	parsons
סייד	syed
עומר	omaar
טושינו	tushino
אלקסיי	aleksei
גיראלדו	giraldo
קמבודיא	cambodia
זין	xin
ואסקו	vasco
טורי	torre
נהאלפו	nhlapo
קוין	qin
דרולוביטש	drulovic
סימוקונדא	simukonda
וין	win
קמבאט	combat
לאסזלו	laszlo
לין	lin
סטראק	strack
ריוג'י	ryuji
חקי	haqqi
שילד	shield
ורוניקאז	veronicas
הומבירטו	humberto
בראילא	braila
קרקואן	kerkouane
ספין	spen
וולטא	volta
פינגר	finger
קיארוסטאמי	kiarostami
אביגייל	abigail
מוריד	mourid
אפיצ'ט	apichet
מוראד	mourad
קאזוקי	kazuki
בירתוד	berthod
פולאט	polat
מישימא	mishima
סעיד	said
קויצ'י	koichi
סאנטאנג'לו	santangelo
נצר	netzer
קובאר	kubar
שפר	shefer
דיאן	diane
יריבאן	yerevan
רומירו	romero
פוסן	poussin
ניקולוס	nicolaus
בוכארא	bukhara
קאלדירא	caldera
היאם	hayam
מובי	moby
ווסאם	wesam
טאפט	taft
אלבנא	albanna
לוסימי	lossemy
טריביסו	treviso
חוסאם	hussam
ליבי	libby
פאפון	papon
שיקיבו	shikibu
ג'ודית	judit
טאקאהירו	takahiro
מוסטפא	mustafa
קאמילא	camilla
גונאריס	gounaris
סובארו	subaru
גילברטו	gilberto
אנתוני	anthony
וירג'יני	virginie
מוטורולא	motorola
ראדישי	radice
הומוסיסטין	homocysteine
מארילין	marilyn
عאסילי	vasili
הארדן	harden
קרימרז	kremers
קאיל	kyle
היקובא	hecuba
טחוטמוס	thutmose
הידי	hedy
ג'אקאר	jacquard
שריהאן	sherihan
קאפר	kuffer
דחלאן	dahlan
אנריקו	enrico
ראשקי	raschke
פינושה	pinochet
אבא	abba
ריקס	reichs
מקאוי	mekawy
פומפון	pompon
לידוקאין	lidocaine
וול	wall
מאנדולא	mandola
הובז	hobbes
הוסין	hocine
מבאבאן	mbabane
פומפידו	pompidou
רדמונד	redmond
מנדלסון	mendelssohn
נובאר	nubar
קורוסאוא	kurosawa
ספאניש	spanish
רפאל	raphael
קורוקאוא	kurokawa
ואסיל	vassell
סוראסקי	suraski
בארניא	barnea
קרמניץ	kremnitz
סאבינא	sabina
דונטסק	donetsk
אמפיריא	imperia
קאיאל	kayal
באיקאל	baikal
לאמארטין	lamartine
איקיא	ikea
קרבייל	kerviel
טרולי	trulli
מאריניטי	marinetti
סב	seb
הארבין	harbin
ברלין	berlin
קסר	qasr
סאידו	saidou
מאזויקי	mazowiecki
ספאיק	spike
ויויאן	vivien
קורזאין	corzine
ונדי	wendy
אפוליא	apulia
איסטנבול	istanbul
מאקפאדין	macfadyen
הראל	harel
רודריק	roderick
אסד	assad
גארד	gard
דקלן	declan
מורטן	morton
טראנסילוואניא	transylvania
דימיתיל	dimethyl
טריסור	tresor
טורה	toure
קלוביס	clovis
שיראישי	shiraishi
מורטן	morten
רומאריו	romario
אלקסנדרו	alexandru
טורו	touro
קי	kyi
קולברט	colbert
מג'אלבי	mjallby
ג'יא	jia
קיראסטאס	kyrastas
ליא	lia
עזוז	azouz
נוטינג	notting
מנסור	mansour
דיטליב	detlev
בסימר	bessemer
טארין	taryn
מנדי	mendy
קינטארו	kentaro
טוראני	tourani
נאיט	knight
קריסטין	christine
פאטמיר	fatmir
קאנינג	canning
תמר	tamar
טמאס	tamas
אנפילד	enfield
פנטיקוסט	pentecost
רוזאלין	rosalynn
אודן	audin
מורין	maureen
מאריק	marek
לינדל	lendl
הולידאי	holiday
יוריטומו	yoritomo
לאורסן	laursen
אסיא	assia
מונטאגיו	montague
קאנאבארו	cannavaro
מאדהיא	madhya
אלעלי	alali
סוליימאנו	souleymanou
זלר	zeller
וארסו	warsaw
וסלנדר	wislander
גורירו	guerrero
מונטיאן	muntyan
קולווין	colvin
דיין	dayan
בילאדי	bilady
קאפאדזה	kapadze
עיסמט	ismet
פיאר	pierre
קריסטו	christou
אלשאפעי	elshafei
פיריז	pires
גילברט	gilbert
מאריוס	mariusz
ואדיסואב	wladyslaw
ראמאז	ramaz
ריאד	riyad
ארגון	arghun
קאריל	karel
ניילסון	naelson
קארן	karen
פוליניזיא	polynesia
פירס	pierce
חג'אוי	hadjaoui
טארטו	tartu
ווקסיביטש	vukcevic
קאלוייב	kaloyev
טוזיא	tauziat
בירות	beirut
אביבים	avivim
סאינקו	saenko
טימורים	timorim
ג'ט	jet
קרימר	cremer
אכאלקאלאקי	akhalkalaki
טאראנטו	taranto
ג'אריד	jared
ליונידס	leonidas
חוראני	hourani
סיהאנוק	sihanouk
סילביו	silvio
נורטן	norton
קפלאן	kaplan
חמאס	hamas
האבילאנד	havilland
קונטאר	kuntar
באיזא	baeza
פרשאד	farshad
פאנינג	fanning
אנטון	anton
וולץ	volz
ברקה	barka
יוז'ני	youzhny
בוריטסו	buretsu
סאיאקו	sayako
גרימי	grimi
פארוק	farouk
רודולף	rudolph
פופ	pope
הידאקא	hidaka
ג'ורג'	georges
פאסילינא	paasilinna
בושמן	bushmen
ביביטו	bebeto
הופ	hope
יחיא	yahya
קומורא	komora
מאטסוי	matsui
סאבאי	szavay
דיקסיט	dixit
ואסיליס	vasilis
פאסטון	paston
סילויי	selway
דבוז	debbouze
פאריס	paris
ראקוסי	rakosi
אלאיג'ה	elijah
סאורי	saori
חקי	hakki
נארי	narey
רסלאן	raslan
פלוריאנו	floriano
טאטו	tautou
מירטסאקר	mertesacker
די	dee
האויר	hauer
אוראקל	oracle
פויטינגר	peutinger
היאנג	hyang
ויי	wei
פאצאצוגלו	patsatzoglou
מיכאיל	mikheil
אריסטיד	aristide
לאבא	lava
סטאמאיל	stamile
ראיצ'ל	rachael
זומא	zuma
גריי	gray
רובינסונז	robinsons
גאלאנד	galland
איבינד	eyvind
דאלטון	dalton
סיד	sid
רולדר	roleder
גינסבורג	ginsburg
קראנקל	krankl
יוליאנטו	yulianto
פארני	fahrni
הינאן	heenan
טרות	truth
דנהולם	denholm
לוטפי	lutfi
אן	an
פריסקוט	prescott
פרוצו	pruzzo
דיבאילדר	devilder
קמאל	kamal
קארו	carew
אנדרו	andrew
אומבריא	umbria
פישמאן	fichman
ורמיילן	vermaelen
סייג'י	seiji
סוטיריוס	sotirios
גולדסטין	goldstein
ביניטו	benito
מיטשל	mitchell
חאפז	hafez
באלדרי	baldry
סאדוק	sadok
נאסר	nasser
ריכא	reija
פידרלאין	federline
מונקי	mongke
שירין	shirin
קראניקאר	kranjcar
נורי	nouri
מארטי	marti
מיגליורי	migliore
וירן	vern
גאראדאנוב	garadanow
שאמבירס	chambers
ריידון	radon
דאסטין	dustin
ראדוי	radoi
ויסטולא	vistula
בלומנתאל	blumenthal
בוראוי	bouraoui
עבידי	abedi
אסטאדיו	estadio
סאביר	sabir
גואנטאנאמו	guantanamo
אסקי	ascii
בוגארט	bogart
האבר	haber
סיפוס	sipos
עטא	ata
נאמדי	nnamdi
מאנהאים	mannheim
נהרו	nehru
סולאקבלידזה	sulakvelidze
ראכש	rakhsh
גנדא	genda
ניקוליטש	nikolic
אומאן	aumann
הירקיוליז	hercules
שולטז	schultz
אקאייב	akayev
וירן	vierne
ניזיביטש	knezevic
טאהר	taher
זיריאב	ziryab
פלאוץ	plautz
רביע	rabie
בוסיניטש	vucinic
ליון	leone
רביע	rabia
פינדי	fendi
חורי	khoury
לו	lew
ניו	new
סודיום	sodium
אוגסט	auguste
קינטא	kenta
ניטו	netto
מולייר	moliere
זאימוגלו	zaimoglu
מירל	mirel
מיריק	mirek
הולירית	hollerith
פאטיל	patil
נובוטנא	novotna
רונטגניום	roentgenium
סאלמין	salmeen
פירוגיה	peruggia
סימאס	simas
סאיזמור	sizemore
דניסטר	dniester
סאחל	sahel
גאלאקוס	galakos
סטיפקא	stefka
פאלאטינייט	palatinate
פאוזיני	pausini
הולמז	holmes
וינטר	venter
פאסטראנא	pastrana
פולאנסקי	polanski
זוראן	zoran
גולן	golan
מילר	meller
קיניאטא	kenyatta
סוקרלוס	sucralose
קארי	carey
חביב	habib
גוסטאף	gustaf
ראלדיס	raldes
רוז	rose
מיטסומוני	mitsumune
קוון	kwon
בורמאן	bormann
מייג'י	meiji
פיניל	pinel
טורגוט	turgut
שוסל	schussel
סאקיצ'י	sakichi
נאסדאק	nasdaq
סונדרגארד	sondergaard
אולדהאם	oldham
האנקס	hanks
וירג'יניא	virginia
סטיפאנאקירט	stepanakert
אקי	aki
רפח	rafah
סטארק	starck
סורגוט	surgut
דנדאני	dindane
טראוי	traoui
יאספרז	jaspers
רוביק	rubik
גוכאן	gokhan
ברוקינג	brooking
ביטא	betta
קונרז	connors
רוקסבורג	roxburgh
קנפאני	kanafani
בובי	bobby
קייג'י	keiji
רג'אבי	rajavi
אפריקאנר	afrikaner
מאסודי	masudi
רוסנפט	rosneft
סליבי	salibi
אשקלון	ashkelon
אלפרזדק	alfarazdaq
אירביד	irbid
שירו	shiro
קלאן	klan
קרימוב	kerimov
יספר	jesper
ויטיר	wheater
אלן	alan
פיילר	feiler
פינקילקרוט	finkielkraut
קסראוי	kasraoui
אוקאזאקי	okazaki
ג'ושוא	joshua
איבאנהו	ivanhoe
קארלוס	carlos
בריגירי	bregerie
האמינו	haminu
הירבוי	hrvoje
מועמר	maamar
בילבאו	bilbao
בלטעה	baltaah
מובארק	mubarak
גובי	gobbi
באנטוסטאן	bantustan
מילוש	milosz
סינאקי	senaki
ג'וליוס	julius
ניל	neil
שחק	shahak
מלביל	melvil
פאפא	papa
שפיק	shafiq
דבאג	debbagh
קאביל	kabil
אבריל	avril
ספקטור	spector
ברנדאן	brendan
האשים	hashim
ריימונט	reymont
קאפא	capa
ססטיק	sestic
יוניט	unit
ביילינא	bijeljina
ברינאן	brennan
אנומר	anomer
ואנוני	vanoni
אופקים	ofakim
אוליסס	ulises
חלימי	halimi
שונסוקי	shunsuke
סטיבנסון	stevenson
פדרר	federer
ירקוביטש	jerkovic
תרייס	thrace
הוגיז	hugues
דולף	dolph
ספאניק	spanic
בריקסטון	brixton
אריטומו	aritomo
תורה	torah
ניגאקי	niigaki
זנגא	zenga
באלאטון	balaton
לאנדאו	landau
דיימלר	daimler
נובונאגא	nobunaga
זאהיר	zahir
דנמארק	denmark
וישנבסקי	vyshnevskyi
סולאריס	solaris
הנרי	henry
אלקסנדר	aleksander
קוניטסין	kunitsyn
פיירלויג'י	pierluigi
אלמאסזאדה	almaszadeh
פאטאיא	pattaya
מלאדיטש	mladic
הנרי	henri
זאנא	zana
ניקולאייב	nikolaev
קורנתויט	cornthwaite
קאואי	kawai
דאמאנאקיס	damanakis
סידון	sidon
לאבר	laver
לוגי	logie
סדיק	siddiq
קראמניק	kramnik
רפ	rep
נביל	nabil
מניקילי	menichelli
מגדי	magdi
ולאדיקאבקאז	vladikavkaz
משהד	mashhad
ליאו	leo
מעמרי	mammeri
מאתיסן	mathijsen
גיבסון	gibson
זאידן	zaidan
ג'ונייד	junayd
הופקינס	hopkins
לודביג	ludwig
סאמי	sammy
סיביו	sibiu
נומידיא	numidia
קורטיזול	cortisol
גודיריאן	guderian
ודראן	vedran
פריד	fred
רינאלדו	rinaldo
זיגה	ziege
בוי	booy
פירל	pearl
איבן	ibn
קאנתר	kanther
סוקולוב	sokolow
אוסבאלדו	osvaldo
קרייסקי	kreisky
הרבאטי	hrbaty
מיליבאנד	miliband
בוזניאקי	wozniacki
טארדילי	tardelli
פירלמוטר	perlmutter
קאטיפ	katip
בום	bohm
משעל	mashal
אולדפילד	oldfield
מורו	morro
לאגוס	lagos
נימר	nimar
ורטאני	ouertani
בהג'ט	bahjat
שייפלי	shapley
שבתאי	sabbatai
מאגאלהאיז	magalhaes
מאקאו	macau
זנזיבאר	zanzibar
יוקוהאמא	yokohama
אינדיא	india
סאגאנווסקי	saganowski
טוטו	toto
קוסטאנזא	costanza
עאון	aoun
יוהאן	yohan
נוטו	noto
אדיבאסי	adivasi
שלמנסר	shalmaneser
קארפן	karpin
יוקיצ'י	yukichi
דלביקיו	delvecchio
מיאנמאר	myanmar
גוטו	goto
ברינדל	brendell
הנאנו	hananu
מוראן	moran
מיהאיל	mihail
אלגמל	elgamal
מולינגא	mulenga
מוזיניטש	muzinic
ניקי	nikki
האותורן	hawthorne
מאלדונאדו	maldonado
חראם	haraam
פוארטא	puerta
זיל	zell
רי	rhee
היבירט	hebert
סילינא	selena
גלוטוב	glotov
קלוד	claude
קאזויא	kazuya
פקרי	fekri
קונסטאנטינסקו	constantinescu
באנקס	banks
טורי	tori
קולז	cools
בל	bell
מיוקי	miyuki
ארמאנדו	armando
ראסא	rasa
ברנאל	bernal
מנוצ'הר	manouchehr
חיאטו	hayatou
סיבוק	sivok
לאסילס	lascelles
דורי	dori
גאסטון	gaston
קנט	kent
קאלום	calum
באהר	baher
בנט	bent
סנט	cent
טסירקבא	tserkva
דימיריט	demerit
שבאב	shabab
חאידארי	chaidari
סאמפאיו	sampaio
חוסה	jose
דימונה	dimona
הש	heche
איליא	ilya
דהן	dehn
פיהן	fehn
וולודימיר	volodymyr
מינו	meeno
סילואן	silwan
קריסטנסן	kristensen
ביתנו	beiteinu
ניקיטא	nikita
שיקאגו	chicago
אלטא	alta
סטיינבק	steinbeck
נפאל	nepal
סקורסיזי	scorsese
סועאד	souad
מקבראיד	mcbride
שילר	shiller
ג'באר	djebar
אוגאנדא	uganda
וינונא	winona
לובודזינסקי	lobodzinski
קופקה	kopke
טוקאנטינז	tocantins
מוטי	muti
גראנדס	grandes
סילביסטר	silvestre
שנאידרהאן	schneiderhan
מודיסי	modise
סביטוסלאב	svetoslav
באס	bass
בוטינג	boateng
פאיוס	pious
מיל	mile
פראנסס	frances
קין	keene
טיימוריאן	teymourian
יהלום	yahalom
באמאקו	bamako
פאהד	fahed
פיליגריני	pellegrini
מיגל	miguel
קינקל	kinkel
קלוס	klose
פורטוני	fortuny
פונד	pond
פיטר	petr
לוזאן	lausanne
יאמאגישי	yamagishi
סוזא	sousa
דורס	durs
גרינספאן	greenspan
ביקילא	bikila
מוזלי	mosley
איבא	iba
פאנטיליטש	pantelic
זוהר	zohar
ברימנר	bremner
בריגם	brigham
פראיור	pryor
נסראללה	nasrallah
טודורוב	todorov
סידהום	sidhom
טאמוקסיפין	tamoxifen
סוסמות	sussmuth
שולז	sholes
באנדירא	bandeira
וייל	vale
סאנטון	santon
גלילי	galili
מיטאליקא	metallica
האטסומי	hatsumi
פינלאנד	finland
קוקן	koken
תאבו	thabo
סנה	sneh
קונרי	connery
קרונבאך	cronbach
יארדלי	yardley
הירסי	hirsi
טימי	timmy
דארין	darren
רוסו	roseau
שבתאי	shabtai
ניסר	nisr
אלברטי	alberti
מארגריט	margaret
קוראס	coras
ריביירו	ribeiro
סמירטין	smertin
לאורידסן	lauridsen
סטייפלטון	stapleton
יאסודא	yasuda
ג'רמי	jeremie
רחמאן	rehman
סיסיליא	cecilia
נימיץ	nimitz
מקנר	mechner
פאטיח	fatih
טופולאניק	topolanek
גולאנסקי	golanski
מיטיטש	mitic
דילפי	delphi
מלאדן	mladen
טוראם	thuram
בארישא	berisha
גאריסב	gariseb
דלאילה	delilah
פונדא	fonda
מאידן	maidin
נונאבוט	nunavut
שינודה	shinoda
קביסט	qvist
ביר	beer
סאנדרז	sanders
דאוד	daoud
רינאלד	reynald
פרויאס	proyas
פוטוקארי	potocari
סמיתיז	smithies
שולא	shola
אלגיטאני	elghitani
קולין	colleen
ניז	knez
ואוא	vava
באבנגידא	babangida
טאגו	tagoe
פדרו	pedro
סולו	solow
אנטיגוא	antigua
לאדא	lada
בוקוביטש	vukojevic
מיקה	micah
עמארו	umaru
מוזאמביק	mozambique
טיקו	tico
ויטאליס	vitalis
גוראן	goran
באהי	bahi
מיוס	meeuws
חנון	hanoune
בראהי	brahe
פארק	parc
ז'ול	jules
אליאקסאנדר	aliaksandr
לורנז	lorenz
נורודום	norodom
קארדילי	cardilli
טשארוויט	charvet
ראינהארט	reinhardt
ראימונד	raymond
בארקליי	barclay
קוקיס	cocis
קוקסון	coxon
מארקוב	markov
פרדינאנד	ferdinand
רוי	ruwi
בליס	bliss
קודא	koda
ואנאהימר	vanaheimr
ורלן	verlaine
ורקואטירין	vercauteren
פיין	payne
גודא	goda
צ'אפורין	chafurin
בילייד	belaid
בורלא	burla
חופי	hofi
קופי	kofi
פרידמאן	fridman
סרחאן	sarhan
מסארו	massaro
לאשלי	lashley
קאבול	kabul
פריי	frey
סלון	sloan
ביוט	butte
גנזורי	ganzouri
בגזילא	bugzilla
קוינטין	quintin
ראסק	rusk
באטיא	bhatia
ביניסיו	benicio
קלופ	klopp
פראניטש	pranjic
מארסילינו	marcelino
סטריטמאטר	strittmatter
ראמליאק	ramljak
הילגירא	helguera
ז'ו	zhu
מוניו	moneo
מיליגאן	milligan
שנאידר	sneijder
סאנטורו	santoro
גסטאפו	gestapo
מודג'י	moggi
ג'רוסאלם	jerusalem
מחידלי	mehaidli
מאשיגו	mashego
גאלאגר	gallagher
גארגו	gargo
ניארקו	nyarko
ארזי	arazi
תורו	thoreau
סוגייאמא	sugiyama
אילם	elm
סאנז	sanz
דורקהיים	durkheim
טאיסון	tyson
נוסטרא	nostra
קינז	keynes
ליטבינוב	litvinov
הוד	hod
שרודר	schroeder
ג'וליטי	giolitti
וודן	wooddin
קוסומי	kusumi
מוצ'יזוקי	mochizuki
הוליין	hollein
קוניב	konev
זאמוראנו	zamorano
לינסטרא	lenstra
בלאנקו	blanco
פישר	fisher
סמרקנד	samarkand
רומאנוס	romanos
קוריוליס	coriolis
גלוטאמין	glutamine
מלרוז	melrose
פריסטינא	pristina
רוזנבלום	rosenblum
דיארבקר	diyarbakr
נוריהירו	norihiro
ראדיוהד	radiohead
מחמוד	mahmoud
בילונג	billong
דאסאייב	dasayev
יוסופי	jusufi
ג'וליא	julia
קינגסטון	kingston
קולידג'	coolidge
לאבין	lavigne
סיגריד	sigrid
אדייר	adair
יושירו	yoshiro
בועב	bouab
בלאגויה	blagoja
דונר	donner
קאנייה	kanye
הולדרלין	holderlin
לימאן	lyman
מילפורד	milford
סעדאן	saadane
פראנסיסקו	francisco
פייגן	fagan
קורנואל	cornwall
רוסוליני	rossellini
קונסטאנטיוס	constantius
שרבאט	sharbat
סטיליוס	stelios
פיאסקו	fiasco
ברזיטש	brzic
קליידרמאן	clayderman
קאג'יורא	kajiura
פאסקואל	pascoal
סמולינסק	smolensk
סטיף	stif
גרינווד	greenwood
שאף	schaaf
גקזי	geczi
אנדוני	andoni
פאלקאו	falcao
קאלאגאן	callaghan
ארנסט	ernest
תאקסין	thaksin
צ'יפולא	cipolla
דיקינסון	dickinson
מורפי	morphy
פאלאדינו	palladino
שמידט	schmidt
ויסואנאתאן	viswanathan
מטאוע	mattawa
לורי	laurie
שאמיל	shamil
בונר	bonner
בירסק	birsk
קאיא	kaia
מאיא	maia
בוסקו	bosko
זקי	zaki
אטקינסון	atkinson
עלאם	allam
קורניליו	corneliu
אמנון	amnon
ריפיטו	repetto
רוי	roy
מאקי	maki
הנדרסון	henderson
איגנץ	ignac
אשל	eshel
טויוטומי	toyotomi
בולנט	bulent
הונדא	honda
קוסטר	koster
טאקאהאטא	takahata
דינזל	denzel
פולי	foly
ג'ריקו	jericho
פריסטון	preston
סוחה	suha
דינזל	denzil
ויין	wayne
אטופיק	atopic
סיטסובון	setsubun
קוזמין	cosmin
פואד	fouad
יוג'י	yuji
דאפו	dafoe
פירסון	persson
שינגיליא	shengelia
דיוף	diouf
טאמאדא	tamada
וינגאדא	vingada
בולילי	bolelli
ברישט	brecht
בחניני	bahnini
קאנטארו	kantaro
בוסמאן	bosman
חלחול	halhul
עידי	idi
סטיד	steed
פיריני	ferrini
ג'ודי	jody
באיר	baeyer
קקיטי	keketi
סטיל	steel
פוסטר	foster
ז'אנג	zhang
מיין	mayne
אלנמרי	alnemri
עומארי	omari
גירי	gehry
לייבי	lavey
עלוני	allouni
קוסגרוב	cosgrove
חובייקה	hobeika
סושא	sucha
קנדריק	kendrick
לויצקי	levitsky
דירואל	derwall
קארמאנולא	carmagnola
וורילון	vorilhon
טראיאנוס	traianos
נייסמית	naysmith
טיביז	tevez
סאנגר	sanger
סיאול	seoul
פיריירא	pereira
סקאלא	scala
טאקאהאשי	takahashi
מאיסטרוביטש	majstorovic
אלסט	elst
חיירי	khairy
פרנאנדיז	fernandez
מרסידס	mercedes
שיגיושי	shigeyoshi
הוטו	hutu
פירנאנדיז	fernandes
נגרילא	negrila
מוטו	mutu
דוברי	duberry
גיניס	guinness
רימיטיר	remetter
עאסי	asi
פוריסון	faurisson
ג'ואנא	joanna
אברהארד	eberhard
הוריסון	horison
סטאמבאכר	stambachr
בויד	boyd
יול	yul
קוקו	cocu
באסינאס	basinas
ג'ונגר	junger
סלאמה	salameh
סול	sul
גוטפריד	gottfried
אלריטש	elrich
קיסר	keiser
ראסל	russell
טקסים	taksim
יוריפידיז	euripides
לאנג	lang
בראהם	brahem
מיטומו	mettomo
קאפו	cafu
האוסאוי	hawsawi
זקריא	zakariyya
ג'ארזיניו	jairzinho
לוין	levine
פיירינו	pierino
הנידי	henedi
סאבוריו	saborio
רוג'רז	rogers
צ'ידל	cheadle
אליגיירי	alighieri
קלייר	clair
שאנקלי	shankly
חומסי	humssi
יפים	yefim
סטיפנס	stephens
תאנט	thant
אודרי	audrey
טירים	terim
ג'וניור	junior
גאלינוביטש	galinovic
ויטסטשג	witschge
הוארד	huard
דאקוטא	dakota
טאקאשי	takashi
סאראנדון	sarandon
קרוזן	kruzen
טיר	tir
רוסטיסלאב	rostislav
ראני	rani
אנדהובן	eindhoven
פליס	pless
טוקאן	touqan
האני	hani
הירוסו	hirosue
דאלמאן	dahlman
קיוול	kewell
זוביר	zoubeir
נאני	nani
לינאריס	linares
שיין	shane
דאני	dani
נאקאזאוא	nakazawa
גראהאם	graham
ראמבוטאן	rambutan
אדי	eddie
רויאל	royal
הירואקי	hiroaki
ראשד	rashed
פאלאדיו	palladio
סאנטאנא	santana
גוהר	gohar
מידלטון	middleton
קארטייה	cartier
פולסן	poulsen
ג'יניי	jenei
רשיד	rashid
טושירו	toshiro
ג'יניו	jinyu
יומי	yumi
וילוין	welwyn
ווקוטיטש	vukotic
ואקסמאן	waxman
גאבי	gaby
עמנואל	emanuel
שאגאס	chagas
טושימיטשי	toshimichi
קומי	kumi
אנדמול	endemol
בארטר	bartter
ריינהארט	reinhart
ארני	ernie
ואלאך	wallach
טאוב	taube
קיפריאן	ciprian
דונובאן	donovan
פיצג'ראלד	fitzgerald
ראסמוסין	rasmussen
אנגקור	angkor
רשאד	rashad
פאנגז'ו	fangzhuo
ליכטסטיינר	lichtsteiner
פומפיי	pompeii
סום	som
טום	tom
האיד	hyde
דיבאל	devall
מודר	moder
מבומא	mboma
סיזר	cesare
גומאס	goumas
סרבאנטס	cervantes
רוס	russ
תיראבאדא	theravada
דום	dom
חפיט	hafeet
שורי	shorey
קאפסיס	kapsis
בראט	bratt
אלטאי	altai
ראלב	raleb
אלפונס	alfons
מאלטיז	maltese
טראבלסי	trabelsi
באלקאנז	balkans
נוביטסקי	nowitzki
בראטז	bratz
סקאח	skah
רודי	roddy
אוק	uk
חורמחב	horemheb
סומרהאלדר	somerhalder
זבארטנוטס	zvartnots
קארמילו	carmelo
וארגאס	vargas
מילאנו	milano
חליפה	kalifa
קאספר	kasper
ויגור	uyghur
גוילוט	guillot
סימאן	seaman
רינאן	renan
רדיארד	rudyard
דיקר	decker
סיקורסקי	sikorsky
ברו	bru
בוגל	vogel
אנוביס	anubis
יונס	younis
קולשראיבר	kohlschreiber
שמעון	shimon
מוריסיו	mauricio
כאיאשי	khayachi
גוארינו	guarino
רובסון	robson
ברינדא	brenda
יונס	younes
בובאדילא	bobadilla
בנדיקט	benedict
ניקולאי	nicolae
האיתם	haitham
סקאלוני	scaloni
קרים	krim
עוטייף	otaif
בוינו	bueno
דיומאנסי	diomansy
יונוס	younus
זילאיא	zelaya
ניביס	neves
בירניני	bernini
רומינא	romina
קרים	kerim
חוסיין	hussain
סאנסום	sansom
חוסיין	hussein
הרארי	harare
סטרלסון	sturluson
בקר	becker
אלבניה	albania
מואז'ן	maozhen
קניפר	knipper
הולויי	holloway
זיליקו	zeljko
בומיס	bomis
רוג'ר	roger
סוגיהארא	sugihara
סטיפאני	stefani
קאבונגו	kabongo
ג'יבריל	jibril
דורייד	duraid
טורסטן	torsten
מאקלארין	mclaren
אפולו	apolo
קואי	kwai
אראטו	erato
טומאסו	tommaso
ולאסטימיל	vlastimil
מאריאס	marias
ניבאדא	nevada
ליסא	lisa
דראגוסלאב	dragoslav
מירק	merk
קאראבאג'יו	caravaggio
קאנובא	canova
ג'ונאס	jonas
קבאני	qabbani
קירבי	kirby
סאברוסא	sabrosa
פיקאדילי	piccadilly
היני	heaney
אליאסו	illiasu
יאר	yar
פרידריקס	fredericks
דאלידא	dalida
דוגלאס	douglass
סינג'ורו	senjuro
פאסקאל	pascal
חידר	haider
מאיר	meier
ספאליטי	spalletti
לגונה	laguna
גומיס	gomis
ויטרוביוס	vitruvius
ג'יאי	jiayi
דאר	dar
אתרוג	etrog
אלבי	albi
אריזונא	arizona
מיליאן	miljan
טייט	tate
גארבא	garba
קאספאר	caspar
פופיולאר	popular
ואקסמאן	wachsman
האמאגוצ'י	hamaguchi
חמידי	hemidi
בלאש	balash
דאלגליש	dalglish
אידו	edo
דורו	douro
נואקשוט	nouakchott
חצור	hatzor
ענאיאטי	enayati
טובאיאס	tobias
גריגירא	grygera
דיס	diss
רוסלאן	ruslan
רודי	rudy
דלאדייה	daladier
מאזדא	mazda
פיש	fish
דייבידסן	davidson
לינדון	lyndon
ואגנר	vagner
דורבאן	durban
רודבאריאן	roudbarian
ריאן	rayyan
קירי	keri
סאיפאן	saipan
קינסקי	kinski
דומנגיני	domenghini
זארמאך	szarmach
זאקירוני	zaccheroni
בידאטסו	bidatsu
טומוקאזו	tomokazu
בוי	boye
שיך	cheikh
הרמון	hermon
מיקי	mickey
טאסוס	tassos
בראשיאלי	bracciali
הרמאן	herman
סולומון	solomon
מונטאנא	montana
ריאשי	riyashi
סיליש	seles
טארקאן	tarkan
פלאסידו	placido
היסה	hesse
גאבריל	gavriil
גרשון	gershon
מאקאפא	macapa
פיקאסו	picasso
קונסטאנטין	constantin
אקרמאן	ackerman
קונאן	conan
גאספאר	gaspar
מסינא	messina
מורר	maurer
דקלים	dekalim
רומיולוס	romulus
קאזויושי	kazuyoshi
קאב	cub
קאליניטש	kalinic
טאמיט	tammet
יונג	young
ביג	big
דאריוס	darius
קארר	karrer
באדוליו	badoglio
קריס	kris
פורסטר	forster
מונטוליבו	montolivo
סיגאל	seagal
אקאדימיה	accademia
סארטג'י	saartjie
קציר	katzir
דיאבי	diaby
קאטזר	katzer
פארוק	faruk
מסי	messi
רוזיטי	rosetti
ברויסארט	broissart
מידאן	medan
הלן	helen
עאמר	amer
ספיצר	spitzer
בויאצ'ק	vojacek
היליגין	heyligen
הדמאן	hedman
וונדרליש	wunderlich
קיזיל	kyzyl
הריסטוב	hristov
פוסאקו	fusako
מייניו	meynieu
קינוק	kinnock
דובסון	dobson
דוליטל	doolittle
שיבאנטון	chevanton
בלייר	blair
סילאסי	selassie
חדית	hadith
ניקולו	nicolo
דומיניק	dominik
קאנטאבריא	cantabria
רתרפורד	rutherford
נאקאיאמא	nakayama
גובלז	goebbels
נילי	nili
ויאצ'יסלאב	vyacheslav
תאליא	thalia
ג'נטיאנא	gentiana
אוברי	aubrey
ואטסון	watson
מאתיו	matthieu
פאו	pau
ג'אנוסקי	janowski
פאראסיטאמול	paracetamol
ג'סי	jesse
ברול	brul
מיליס	meles
קיניי	quesnay
מאקקינא	mckenna
מיסיסיפי	mississippi
ויצמן	weizman
מונתסר	montasser
בו	bau
בוזאן	buzan
עיון	ayoun
בון	bonn
בוזאו	buzau
גאריקס	garics
ראמאזוטי	ramazzotti
נאטאסא	natasa
גוטמאן	guttmann
דאבידקא	davidka
הידיטושי	hidetoshi
פורפיריא	porphyria
דיאנא	dhyna
קופל	koppel
הארפו	harpo
האטאפורן	hatthaporn
פונזיו	ponzio
גיל	gilles
גלבוע	gilboa
האן	hahn
דאראבונט	darabont
יאן	jahn
בריסון	brisson
ורקוטר	vercoutre
מינאמבריס	minambres
גאלאהאד	galahad
בוכארין	bukharin
לאריג'אני	larijani
אריטריא	eretria
ליאקוב	liakhov
פולק	folke
גויבוזא	guebuza
ריגן	regan
טאקאנוהאנא	takanohana
לאיוטא	liotta
בוק	boc
מאריא	mariah
זאינאדפור	zanidpour
מסייה	messier
מאידא	maeda
גוזאן	guzan
סילסטין	celestine
אנאהאים	anaheim
מונטאן	montand
בארזאני	barzani
עבדוה	abduh
אינדוניז'א	indonesia
דואין	dwyane
ויטלאסיל	vytlacil
עיאש	ayache
בורלאנד	borland
עורוה	urwah
הית	heath
טיירי	thierry
בודרום	bodrum
צ'ארודין	chaeruddin
אקואדור	ecuador
ואריז	juarez
יארנו	jarno
פרידנסראיש	friedensreich
וים	wim
מיכאליטשינקו	mykhaylychenko
ג'אוהר	jawhar
ג'אניני	giannini
ראבין	ravin
פורד	ford
מינו	meno
הודל	hoddle
ג'רם	jrme
היאם	hiam
סעוד	saud
קיראלא	kerala
מודינגאי	mudingayi
ליאם	liam
קסאב	kassab
בוליקן	bulykin
מוד	maud
סימיוני	simeone
סיסינהו	cicinho
דאוד	daud
בליז	belize
קאתקארט	cathcart
פרידריק	friedrich
מארטי	martti
קזאנתופולוס	xanthopoulos
מייזונו	maezono
מאג'ר	madjer
טימו	timo
פונטאנא	fontana
דאמיאנוביטש	damjanovic
פראו	frau
לאניזי	lanese
קיד	kyd
אלפונסו	alfonso
פרידריק	frederic
ויטיג	wittig
שב	cheb
קוס	coase
קרוקיט	crockett
טאופו	taupo
סרפסקא	srpska
פרגוסון	ferguson
מאטאוס	matthaus
קארלטון	carlton
קוסט	coast
דג'ורו	djourou
טופר	topher
קוסיי	qusay
לוקזאק	luczak
מאלון	malone
קאנפורי	kanfory
קארטיס	curtis
סיפאנדון	siphandon
ג'ול	joel
גאנגניהיסו	gangnihessou
יוקיא	yukiya
ויקי	wiki
טורוסידיס	torosidis
קיקי	kiki
מיקי	miki
זורן	zurn
ספ	sepp
היקרסבירגר	hickersberger
קיאראן	ciaran
אבחור	abhur
יואן	yoan
ראלסטון	ralston
סקופילד	scofield
פיליפי	felipe
היילי	hayley
שרק	shrek
ולאדיקא	vladica
באה	bah
ג'ון	joan
דאם	damme
קרותרס	crothers
בירקלי	berkeley
האיג'רוגראפי	hydrography
גירוקאסטר	gjirokaster
קובי	cobi
דנשואי	denshawai
קארו	kaoru
אנדריאס	andreas
אלמאלח	elmaleh
קורטיס	curtiss
רוגיבין	roggeveen
קאפקא	kafka
רידל	riedl
ויניטיאן	venetiaan
איפל	eiffel
ראטומיר	ratomir
לאנסינג	lansing
קאהאנא	kahane
זאורי	zauri
ראדהא	radha
מודיליאני	modigliani
עין	ayn
קאלושא	kalusha
ראדי	radhi
לורי	lurie
רינסינברינק	rensenbrink
בוטילי	butelle
דרבייט	dervite
עליא	alia
סאטראפי	satrapi
ארמאנד	armand
אליא	elia
קאיאווא	kajava
דיזני	disney
ויקטוריאנו	victoriano
הלמאן	helman
פאסקאני	pascani
ליטגיב	leitgeb
רוזוולט	roosevelt
מאליבאי	malivai
סאלי	sally
דים	deem
מוריסיט	morissette
זילע	zeila
אוקוונואני	okwunwanne
דיאוארא	diawara
אנגליא	anglia
קינאסט	kienast
טוג'י	tugce
דראקו	draco
מומבאי	mumbai
סיסומאגא	sesumaga
מוטסטיג	meutstege
פוליין	polyene
סאנטי	sante
סוזאן	susan
סאנטא	santa
סוסאק	susak
הולקר	holcer
גאדיש	gadish
סאנטו	santo
בול	boulle
דיבא	debbah
הושי	hoshi
שאמון	chamoun
מאירא	myra
הاירובסקי	heyrovsky
בילוני	bellone
באקר	bucker
ניליס	nellis
קרישצ'אנסן	christiansen
טסונאיושי	tsunayoshi
קארולאין	caroline
טאבוקי	tabucchi
טינג	ting
גוטנברג	gutenberg
מאילארט	maillart
קינג	king
לינג	ling
מינג	ming
מאהאראשטרא	maharashtra
בינג	bing
רג'וסקי	rejewski
אנדרסן	anderssen
לוקליר	locklear
חברי	habre
אפליק	affleck
ג'לול	djelloul
בגאג	begag
קיסאריב	kesarev
צימבאלאר	tsymbalar
דוראסו	dhorasoo
גרינלאנד	greenland
בריטאן	britain
אלמוניא	almunia
סילאידזיטש	silajdzic
ביארני	bjarni
פראנז	franz
הל	halle
פאנטיני	fantini
זאידיה	zaidiyyah
דילאס	dellas
קריסטופורו	cristoforo
קונטאדור	contador
ג'נטלסקי	gentileschi
מג'יד	majeed
צ'רי	cherry
לג'נד	legend
גודילי	gudelj
משה	moshe
קארדינל	cardinal
קילא	kila
מילא	mila
בילסטרום	billstrom
האצ'יסון	hutchison
דופאס	dupas
זוזימו	zozimo
פיני	pini
שוירי	shwery
ויואלדי	vivaldi
רסול	rasoul
קלימינס	clemence
זורו	zoro
בוטור	butor
טורטולא	tortola
ונזוילא	venezuela
דיני	dini
האימור	highmore
תורמאן	thurman
קאלסטרום	kallstrom
דוריקס	durix
קיורי	curie
טימושינקו	tymoshenko
עליוי	alioui
גארמנדיא	garmendia
טוקוגאוא	tokugawa
בובניק	bubnik
רודר	roeder
אלבאראדו	alvarado
רו	roux
קושי	koshi
בורק	burke
יורקמיק	jurkemik
ג'ונביניט	jonbenet
יוקיו	yukio
אמציה	amatzia
ראימון	raemon
טאמבורא	tamboura
זינטא	zinta
קן	ken
היילנס	heylens
מאריוס	marius
קריסטי	christie
קארל	carell
בן	ben
נאיטון	knighton
קאראטירא	carretera
מוזדליפה	muzdalifah
קורדיסטאן	kurdistan
זאקרמאן	zuckermann
לאסלאנד	laslandes
לאמאין	lamine
סואריז	suarez
ראש	rush
טרימולינאס	tremoulinas
מינוט	minot
סלאבא	slava
סאר	sarr
ויקאש	vikash
הירשיל	herschel
אבי	abie
טומי	toomey
לאסט	last
דמבלדור	dumbledore
טוסיטש	tosic
שמולק	schmolck
קאר	carr
טובין	tobin
קוסאו	kusao
קאדליץ	kadlec
דפנא	dafna
ליביו	liviu
פוטון	futon
פראנשיני	francini
צ'אמוט	chamot
ברוהין	bruhin
קאנטי	kante
גוסטאבו	gustavo
שיקארד	schickard
טומאס	thomas
מוסו	musso
סוסקיטש	soskic
מילורא	melora
האידוק	hajduk
מירבין	mervyn
מודאר	mudar
קרוגר	kruger
בלאגויה	blagoje
לירד	laird
ולאדו	vlado
חוסאם	hossam
וולדמורט	voldemort
אדיב	adib
דוקירטי	docherty
קוקושקא	kokoschka
סאמסון	samsun
ניסאן	nissan
גיסקארד	guiscard
נג'יב	najib
סאלאמפסי	salampessy
איבו	ivo
רויסי	rouissi
דאל	dahl
בוראל	boral
שריף	sharif
סאמסון	samson
ג'רמי	jeremy
איוסיף	iosif
חוסני	husni
ניקולאי	nicolai
בריג'ט	bridget
סלהב	salhab
סאלינקו	salenko
הולט	holt
קיאר	kjar
לונדן	london
רינו	reynaud
יבגני	yevgeny
קארבאכאל	carbajal
בולט	bolt
קולט	colt
בויטן	buyten
זיקו	zico
יוסי	jussi
פרופיין	propane
רישטהופן	richthofen
ריקו	rico
פירארי	ferrari
טאקאגי	takagi
סינקיביטש	sienkiewicz
יושצ'נקו	yushchenko
מיוג'ן	myojin
לאורו	lauro
ליאנדרו	leandro
ניקו	nico
באהאמאס	bahamas
פכרי	fakhri
בורנסטאין	bornstein
זיגיד	szeged
ויו	view
האשמיאן	hashemian
אינדיאנא	indiana
איברא	evra
אסטילי	estili
פוטושופ	photoshop
דאלי	dalli
קונסטנס	constans
לוסין	leucine
הל	hull
דוסאן	dusan
לוליא	lulea
יוג'ין	eugene
דאנטה	dante
וס	wes
לס	les
באלמר	ballmer
פאסקואל	pasqual
איס	aes
טוצ'י	tucci
ג'ונז	johns
קולמאן	coleman
ראובן	reuven
עיראקי	iraqi
סלאח	salah
סקוטי	scotty
זוקורו	xucuru
צ'אן	chan
קארלהאינז	karlheinz
קון	kuhn
בלמונדו	belmondo
פיישאנס	patience
קרוג	krug
רולפס	rolfes
פואנקארה	poincare
אימאמורא	imamura
ראינהולד	reinhold
אורנילא	ornella
אוטאדא	utada
ניר	nir
קשוע	kashua
ויהורסט	wieghorst
אניו	ennio
גוגן	gauguin
גושו	gosho
האמפדן	hampden
ג'אמפיירו	giampiero
מרנפטאח	merneptah
סובאג'	sauvage
לאיבלי	lively
גינתון	ginaton
ליזא	liza
זאור	zaur
שול	scholl
פילטון	pelton
פיירו	piero
בויבודינא	vojvodina
גנארו	gennaro
עיראק	iraq
ויליאם	viliam
סטאד	stade
פיק	fiqh
בריاל	braille
שאפירא	shapira
שאקיב	shakib
קולונא	coluna
גאלי	galli
גודמאן	goodman
רנשלר	renschler
וילניוס	vilnius
רוקוול	rockwell
גאלא	galla
דימבא	dimba
זאקארילי	zaccarelli
קונסטאבל	constable
האבל	hubble
שאקלטון	shackleton
סרג'יו	sergio
שיאבוני	schiavone
מילז	mills
אחמד	ahmad
ורנר	werner
מינץ	mintz
פאנאגוליאס	panagoulias
באנגורא	bangoura
דימיטרי	dimitri
פאלא	falla
ליבר	libre
סוכוי	sukhoi
טאימאנוב	taimanov
לילי	lilly
לופאטילי	lupatelli
סימאק	semak
אירא	ira
אופר	ofer
רודולף	roudolphe
טינאנט	tennant
סטון	stone
מודריק	mudrik
אלקסאנדרינא	alexandrina
פאנטא	fanta
ביט	bette
פראנס	france
ורנר	verner
חאג'	hadj
סטאלון	stallone
מלאל	malal
רודיק	roddick
קוניו	cugnot
בנילוקס	benelux
לובין	leuven
לוקהיד	lockheed
ראנד	rand
טאבורדא	taborda
דונם	dunam
טולון	toulon
בובקא	bubka
טרינטון	trenton
בוגניט	bugnet
צ'יקאו	chikao
לאנדרי	landry
שרודר	schroder
שעבו	chaabo
מאדאלינא	maddalena
פיטרו	petru
מסבאח	mesbah
זימר	zimmer
גראפשאפ	graafschap
תואיט	thwaite
סלטן	selten
פיורי	fiore
קריסטי	christy
האופטמאן	hauptmann
האנסי	hansi
פירין	perrin
קלאם	kalam
סמולאריק	smolarek
רוסטי	rosti
באנטון	bunton
הרולד	herold
באליטש	baljic
בובולינא	bouboulina
קאלאף	kalaf
גארסיא	garcia
קריסטיאנסן	kristiansen
פיליפ	phillip
ורתינגטן	worthington
דמיטרי	dmitriy
דורג'י	dorji
ניאנדורו	nyandoro
אלונא	alona
טד	ted
בוגוטא	bogota
קאטון	catton
אלוני	aloni
ג'לאל	jalal
מיקולאיב	mykolaiv
רמאל	rammal
קאסים	qasim
ואיט	wight
לואל	luol
מונונוק	mononoke
לב	lev
שרווד	sherwood
דאוויניו	davinio
הירדא	herda
איביריא	iberia
מורישימא	morishima
זויטרמיר	zoetermeer
געגע	geagea
פוכנר	puchner
בומר	bommer
אלבעת	albaath
לידהולם	liedholm
קורוליוב	korolyov
מאנסארי	mansare
צ'יונה	chiune
גיגיא	ghiggia
דיור	dior
ביסינטי	bixente
פרינגז	frings
ג'ורג'סקו	georgescu
סילין	selene
רולף	rolff
מירסין	mersenne
ניקולו	niccolo
וורדי	verdi
לו	liu
לאסקר	lasker
אסקובאר	escobar
פיזא	pisa
גיריסי	giresse
ברצ'ם	barcham
רוני	ronny
ורדי	verde
לאורי	lowry
לירונד	lerond
פאנאנדיטיגוירי	panandetiguiri
פירוץ	perutz
ויירי	vieri
מילאדינוביטש	miladinovic
דיפי	diffie
מולדובא	moldova
פודולסקי	podolski
שקספיר	shakespeare
ראפופורט	rapoport
אלאנואר	alanwar
טאמיל	tamil
טיאסי	tiasse
מאיול	maillol
טראפאני	trapani
רינולט	renault
בורינאז	boreanaz
אדידס	adidas
ג'אנלוקא	gianluca
לאברוב	lavrov
סנורי	snorri
מאזוט	mazut
לורנס	laurence
פייטון	payton
דקיוס	decius
שנאבל	schnabel
ואט	watt
בסון	besson
אלברטא	alberta
מארטוב	martov
קאלאבריא	calabria
פולארד	pollard
בילי	billy
רנה	rene
מוקרג'י	mukerji
ואלוורת	walworth
ספייסק	spacek
קן	connes
רפאל	rafael
רויז	ruiz
אוקו	okko
סודארסונו	sudarsono
קלייד	clyde
איבאנדר	evander
פאצ'קו	pacheco
טייב	tayeb
פאלמא	palma
ג'אסם	jassem
רומאלד	romuald
פאלם	palme
סעד	saad
ג'נינגז	jennings
מימונה	mimouna
אדריאן	adrian
מביא	mbia
פאסטאן	pastan
מאסיו	maceio
קאטרינא	kateryna
מוסאדק	mosaddeq
סירף	cerf
סאבאן	saban
שיראי	shirai
סאקאגוצ'י	sakaguchi
סימוניטא	simonetta
היורי	hyori
פרידון	feridun
בירקמאן	berkman
נורדסטרום	nordstrom
אינגיבורג	ingeborg
רפאלי	raffaele
הירודוטוס	herodotus
ג'נקס	jencks
טישו	tessho
קרול	krul
ריד	reid
פאונד	pound
גוסלינג	gosling
פרעון	pharaon
סטיפאני	stephanie
קונו	konno
גלאל	galal
אלג'בל	aljabal
סימפל	simple
גוארין	guerin
טפילו	tefilo
סיונקו	sionko
סאברי	saberi
קאסדאן	kasdan
ליי	lei
ג'וני	jonny
האיז	hayez
ג'זירי	jaziri
ראבואל	rabuel
ג'אווד	jawed
חסן	hasan
הייז	hayes
פורסל	purcell
ג'ודט	judt
פאינגולד	feingold
חאיק	hayek
טאלבאני	talabani
מקאם	maqam
טורקואטו	torquato
קנזאבורו	kenzaburo
הנדל	hendel
פרוקסימא	proxima
פארקס	parks
שוסטיקוב	shustikov
אימרי	imre
שאהנאמה	shahnameh
בונארד	bonnard
אנגילא	angela
נובל	noble
קאבול	kaboul
קובינו	cobeno
איגליסיאס	iglesias
קוסט	coste
ויץ	weitz
קוסטא	costa
דיניסוב	denisov
פרונטירא	frontera
זיסיס	zisis
לאסאל	lassalle
ריקיא	rikiya
פוניני	fognini
לידיסמא	ledesma
מינאואנד	minavand
עפרה	ofra
נוויל	neville
איסלאם	islam
סידנא	sedna
בירן	byrne
הלנא	helena
שוארץ	schwartz
יושינאקא	yoshinaka
סקופיי	skopje
דריסא	drissa
נואל	nawel
שיאושו	xiaoxu
טסובוי	tsuboi
באסם	bassem
סוייזי	swayze
דוכובני	duchovny
פאנטוליאנו	pantoliano
אוטי	oti
מאיר	mayer
קאתלין	kathleen
אוסטא	aosta
מנדל	mendel
סנופ	snoop
פאפוא	papua
פיטיסטי	pitesti
תאבט	thabit
דובאלייה	duvalier
חוסין	houssine
אריקסון	erikson
שילקא	shilka
קרוס	cross
קוטאיסי	kutaisi
מוחמד	muhammed
יאסו	yasuo
סאפראניק	safranek
ריקארד	rijkaard
גיולא	gyula
בארקלי	barkley
אפולינייר	apollinaire
פקרמאן	pekerman
ואנס	vance
ביסון	bisson
זולאקו	zewlakow
דונא	donna
עסומאני	assoumani
בוריילו	borriello
ראיכשטאין	reichstein
אטאואלפא	atahualpa
קירקהופס	kerckhoffs
באראט	bharrat
קורנברג	kornberg
אירשאיר	ayrshire
טינג'י	tenji
סאיונג'י	saionji
סאביו	savio
סילא	sylla
קאפאדוקיא	cappadocia
ניקוס	nikos
מומסן	mommsen
רביב	raviv
מברוק	mabrouk
ורמיר	vermeer
טיסדייל	tisdale
טוסו	tusseau
קית	keith
ג'בל	jabal
לוין	levin
בראנט	brandt
טרוסט	troost
קייטא	keita
לינה	lena
וולאוויטש	vlaovic
לורנס	lawrence
אלבראדעי	elbaradei
נסיב	nasib
שאפור	shapur
יעקוב	yaakov
בינאגליו	benaglio
גרנביל	grenville
אירבאין	irvine
נסים	nasim
גינא	geena
רומייניה	romania
פראנק	franck
טאישו	taisho
נארמר	narmer
סזינטמיהאלי	szentmihalyi
טרזאן	tarzan
קוגא	koga
פירי	perry
מקאן	mekan
קאבאנאס	cabanas
לארשה	larcher
אימא	emma
אלפרידי	elfriede
קאפיטסא	kapitsa
דמיר	damir
היקטור	hector
נאיף	nayef
טילר	theiler
האנדל	handel
לודביק	ludvik
טאמר	tamer
מאלאוי	malawi
זאקואני	zakuani
מארטינילי	martinelli
מונטירוסו	monterroso
דיפלאס	deplace
קום	kumm
דין	dien
פיאניטש	pjanic
לאקומב	lacombe
ביונסי	beyonce
ביאג'יו	biaggio
דיל	del
קאוונאגי	cavenaghi
סובארי	suvari
מדאח	maddah
שופאן	chopin
סטארי	stari
אזאקי	ezzaki
קאלץ	kaltz
ליניקר	lineker
שאורמא	shawarma
פראנקלין	franklin
אליפתיריוס	eleftherios
באסל	basil
ג'ראלד	gerald
סמיטס	smits
טינגיז	tengiz
צוכארט	zuchardt
קלייר	clare
ריק	rik
וריסן	vreijsen
ויק	vik
הדיגר	hediger
נאנסי	nancy
קלארק	clark
יונגבלויד	jongbloed
ניק	nik
מינורו	minoru
גולון	goulon
חורטסילאבא	khurtsilava
דעיבס	daibes
אוקטוניון	octonion
שאגאל	chagall
טרנופיל	ternopil
מארקס	marks
קטן	katan
מארקו	marko
מונטיז	montez
פלורידא	florida
מהדי	mehdi
קאלאטראבא	calatrava
סאראטוב	saratov
לרדורף	lerdorf
عאלנטין	valentin
סירא	serra
נובארטיס	novartis
האמר	hamer
קורלוקא	corluka
סאביצ'ביטש	savicevic
אדוארד	eduard
סאמואל	samuel
מישר	miescher
גרין	gren
קנג'י	kenji
שימלא	shimla
חאמד	hamed
יליניק	jellinek
דארמיאן	darmian
אלקס	alex
חג'רי	hajeri
ג'יונגהוי	jeonghui
ראפאייטש	rapaic
באירם	bajram
צ'ארפיניט	charpenet
טולאלאן	toulalan
לאדוביסקי	ladovsky
גואדיאנא	guadiana
ונקוב	venkov
איסטקוט	eastcote
אנטוניוס	antonius
רוטבלאט	rotblat
קאטסו	katsu
רודולף	rodolphe
באראמידזה	baramidze
סיגמונד	sigmund
הנריקה	henrique
הילד	held
קארלוף	karloff
טורנאטורי	tornatore
פירסון	pearson
לערוי	laroui
אידריס	idris
פילד	feld
בוגדאן	bogdan
הארל	harrell
דורא	dora
פוטי	poti
שייז	shays
מוקדאד	mokdad
מיליטון	meliton
סאנשו	sancho
יאסף	yacef
מוטי	moti
קונישיגי	kunishige
ז'ירקוב	zhirkov
תמוז	tammuz
קלודט	claudette
הירושי	hiroshi
קדיר	kadeer
ליונל	leonel
דויין	dwayne
באיר	bajer
אמירה	amira
וילהלם	wilhelm
קרייסטון	crayston
באטלס	batlles
טאקומי	takumi
פאיד	fayed
בנדי	bundy
נאטאשא	natacha
ג'אמובאנדו	jamuovandu
פאיז	fayez
אתילין	ethylene
האברמאס	habermas
סטירן	stern
ראדויקו	radojko
תיו	theo
לייטון	leighton
ממלוק	mamluk
שפיק	chafik
רודי	ruddy
יאגור	yagur
דוגריי	dougray
עאסי	assi
ג'קי	jacky
מאיגא	maiga
דייוויד	david
ואלקר	walker
קאמל	kamel
קאמן	kamen
קאמיי	kamei
בוטא	buta
הובארד	hubbard
קייטי	katie
דוראנט	durant
דנקאן	duncan
אינדיק	indyk
סטאנמור	stanmore
גיוניא	ghionea
פליימן	plamen
רוזנברג	rosenberg
ואיאט	wyatt
ריינא	reina
רסול	rasul
דריוטון	drioton
קויומגיאן	kouyoumdjian
באיס	baysse
זבונימיר	zvonimir
סקאלי	schally
לארסן	larsen
פומפיליוס	pompilius
טורק	turk
פיאוי	piaui
טילימאן	telemann
צ'ומסקי	chomsky
מבויאן	mbuyane
היינז	heinz
דוריף	dourif
קידמאן	kidman
וסטמורלאנד	westmoreland
מין	minh
לאואל	lawal
גאלארדו	gallardo
ג'אקובי	jacobi
ג'רי	jerry
טג'לי	tajalli
היני	heini
בארי	barry
גיקאס	gekas
בריסט	brest
טרוג'ילו	trujillo
דמידוב	demidov
בראדלי	bradley
אבני	avnei
דאיסלר	deisler
האינה	heine
אסרור	asror
מיצ'יהירו	michihiro
אימינם	eminem
גראזיא	grazia
ויסליטש	vicelich
יוגוסלאביא	yugoslavia
טושיוקי	toshiyuki
קימוקו	kemoko
אוסטר	oster
מורגנסטירן	morgenstern
אילון	ayalon
קואזימודו	quasimodo
סטרוסטרופ	stroustrup
ג'אמע	jammeh
קאפוא	capua
פוזו	puzo
נתיב	nativ
ברט	bert
סאסארי	sassari
גאבן	gavin
גולבורן	golbourne
קאלמיקיא	kalmykia
קוזאק	cusack
וילארד	willard
ג'ול	jol
רישיליו	richelieu
רימיט	rimet
הרגט	herget
אולימפיאס	olympias
דוזי	dozy
בארוטי	baroti
סאליף	salif
נקונאם	nekounam
דאסיא	dacia
סלים	salim
אלטמאן	altman
ליוויו	livio
רג'ב	rajab
קאמל	camel
לודמילא	lyudmila
פונאריו	ponaryo
סוזאן	suzanne
מונטיבידיו	montevideo
האנוי	hanoi
זבולון	zevulun
פארגיון	fargeon
רינו	renaud
קאקויי	kakuei
אושו	osho
בורגו	borgo
מילארד	millard
יאמאגוצ'י	yamaguchi
גויי	gueye
סיגורני	sigourney
מחמט	mehmet
סטילא	stella
נאואז	nawaz
קוליבאלי	coulibaly
לסניאק	lesniak
לורדי	lordi
טובמאן	tubman
סיביניק	sibenik
פיטורקא	piturca
גארזון	garzon
אדוארד	edouard
קרוי	karoui
וילקשיר	wilkshire
רומר	romer
פליחאן	fleihan
דג'ורקאייף	djorkaeff
ויקי	vicky
נוימאן	neumann
טארק	tareq
קוקס	cox
קרוידון	croydon
רומיו	romeo
שאנטאל	chantal
ויקי	vicki
רוס	rous
קארטראיט	cartwright
ברטי	berti
לואלוא	lualua
גאמבון	gambon
מג'לי	majalli
לוס	lous
בקהאם	beckham
מוזפר	mudhafar
אלבארו	alvaro
אנדר	ander
פיראנדילו	pirandello
ברי	berri
מקדאניאל	mcdaniel
מאקיללי	makelele
סארי	saree
פידור	fedor
פאפי	pape
סטורארי	storari
ברנארדינו	bernardino
דינארא	dinara
קאנוטי	kanoute
סאלומון	salomon
מורטינסין	mortensen
קונרט	kunert
פוין	fouine
ברוניטי	brunetti
אוריליוס	aurelius
לטרייר	leterrier
קמפ	kemp
קולמוגורוב	kolmogorov
בלאנקא	blanka
לאבאקי	labaki
בראינט	bryant
ביוטיטש	vujicic
עליחאני	alikhani
מאלין	malin
קריפטוזואולוג'י	cryptozoology
ביורקמאן	bjorkman
בראיטנר	breitner
בוהין	bauhin
מוס	moss
מארסיא	marcia
אוצ'ידא	uchida
מאיר	meir
סורין	soren
קוני	kone
גירי	gerry
דיר	deir
גיר	geir
בילין	belin
סלאבקוב	slavkov
פאריל	farrell
פירי	ferri
ארון	aron
וילם	willem
נאיג'יריא	nigeria
ולהאוזן	wellhausen
ראידיל	ryedale
ליסקוט	lescott
פאקיסטאן	pakistan
קאלאבאן	kalabane
טראיאן	traian
רונג'י	runje
סטיל	steele
ביטאט	bitat
ליבסקינד	libeskind
פולו	polo
ביטאר	bitar
אטיין	etienne
בריטני	britney
רובניז	robbins
אוגוגו	ogogo
קולו	kolo
פונטופידאן	pontoppidan
יוגלינא	euglena
דזאג'יטש	dzajic
בוראנא	borana
סאמרבי	summerbee
ראלף	ralf
עבعד	abud
מורדוק	murdoch
זיאני	ziani
קונדראטייב	kondratiev
מלמד	melamed
סיגאל	segal
פיט	pitt
ריט	ritt
רמסיס	ramesses
דרוז	druze
מיט	mitt
סיידאת	seidath
מאקוטו	makoto
קולטר	colleter
ניקי	nicky
מיזושימא	mizushima
סטרונטיום	strontium
הוזומי	hozumi
קאמארו	camaro
זלאטקו	zlatko
היפוליט	hippolyte
לחוד	lahoud
הינריך	heinrich
אזד	azd
סאוור	sauer
הינג	heng
סאטיאג'יט	satyajit
זוראב	zurab
סרי	sari
ג'וג'י	joji
קוג'י	koji
איזידור	isidore
מאסלו	maslow
נארימאן	narriman
זיאד	ziad
אינטרפול	interpol
אורלאנדוני	orlandoni
ריאד	riad
פילאיו	feliu
פוגאטיץ	pogatetz
רוני	rony
סוני	sony
שימומורא	shimomura
פאטרישא	patricia
מרבאח	merbah
קאהיל	cahill
בהזאדי	behzadi
ואסארלי	vasarely
דאואלא	davala
מארטינז	martins
פייל	paille
מארטינז	martens
נדב	nadav
וייט	viet
סניורה	siniora
לאזארוני	lazaroni
מוס	mohs
לורין	loren
סטיליקה	stielike
דאליא	dalia
האריסון	harrison
יוקינו	yukino
מאיק	maik
נאיק	naik
וורדזוורת	wordsworth
מאלודא	malouda
טוריו	theuriau
פאריאטי	parietti
פן	penh
מאסאהירו	masahiro
מאיאמי	miami
סאנוגו	sanogo
דיון	dion
קוין	quinn
קורן	koren
יארוסלו	jaroslaw
קייס	case
טאטשיקי	tachiki
רומאן	roman
קוריא	korea
בליין	blaine
בויטיטש	vojtech
דיראני	dirani
המסה	hamsa
קיטשירו	kiichiro
בלייז	blaise
לוביטש	lubitsch
גול'יאן	julien
ח'יגאב	hijab
דומייקו	domeyko
מאקאסאר	makassar
הייזנבירג	heisenberg
סרפנטינאיט	serpentinite
לובונט	lobont
קאפארוני	capparoni
שיריל	sheryl
אלטון	alton
סטוקס	stokes
מייבאך	maybach
מורארו	moraru
ויג'יי	vijay
זוקירו	zucchero
קילה	kela
מירילס	meireles
יאד	yade
רינוניס	renones
טומסון	thompson
טורסנוב	tursunov
שטרית	sheetrit
נאסר	nacer
גאספאר	gaspard
בלארוס	belarus
רודיסיא	rhodesia
טרוטא	trotta
סוקר	sucre
בירינג	bering
שהאב	shahab
קרים	kareem
בונן	boonen
בילאמי	bellamy
זאמברוטא	zambrotta
בארבאדוס	barbados
גליל	galil
ואלדאנו	valdano
נאגי	nagui
גאליק	galic
גינאדי	gennady
ויסל	wiesel
ויסלי	wesley
יוניליבר	unilever
סלאמה	salama
טריף	tarif
סלויטר	sluiter
גאליס	galis
שובו	chauveau
מרדוק	murdock
סופר	sofer
ואלקארידג'י	valcareggi
מאקובי	maccoby
לוס	luce
טאמפירי	tampere
ריד	reed
מוביוס	mobius
הרנאנדיז	hernandez
איסטא	issta
גולדווטר	goldwater
באטו	batteux
פריש	frisch
דאבו	dabo
זרהוני	zerhouni
מיריי	mireille
מיקו	mikko
יומי	yomi
אמריקאנא	americana
אלטון	elton
באראנקוילא	barranquilla
בירטוני	bertoni
ראסטאפארי	rastafari
ברטיני	bertini
יאניק	yannick
פאנא	pana
קאנא	qana
דאטסאקורן	datsakorn
לינץ'	lynch
בארינבוים	barenboim
הנא	hana
פומימארו	fumimaro
יאנא	jana
סיראו	serao
לאנא	lana
גומיז	gomes
נאנא	nana
היתם	haytham
קומאן	koman
מאראצ'	marach
דאנא	dana
קארניי	karnei
קורי	corey
טום	thom
מריאם	maryam
קיומא	kyuma
קיד	kidd
הסטיא	hestia
קרולדרופ	kroldrup
קליברסון	kleberson
ואלאזא	walaza
טאנזאן	tanzan
איבגיני	evgeny
רימיני	rimini
הולזנבאין	holzenbein
סאנדרילי	sandrelli
רייזר	reiser
מקאריוס	makarios
מוסוליני	mussolini
הואסקא	huesca
מרום	merom
באמרונג	bamrung
יאמאשיטא	yamashita
מאנאגוא	managua
סולק	salk
בירקשיר	berkshire
טוליו	tullio
נומא	numa
ואיקינג	viking
טאיסיר	tayseer
דורפנר	dorfner
ביזנט	besant
טראנסקיי	transkei
באמלט	bamlett
ואורזניאק	wawrzyniak
האנס	hans
גוטייריז	gutierrez
ויא	weah
סיזין	sezen
דיגא	degas
שאד	shahd
ג'יצ'י	jiechi
פואטייה	poitier
ייב	dave
ג'ראלדין	geraldine
ארסן	arsen
פארס	fares
טאבארז	tabarez
לאם	lahm
דינוס	dinos
גורן	goren
קולן	collin
ניפון	nippon
רובן	robin
ריקמאן	rickman
מארטיניז	martinez
ברודי	brody
נאקאסונה	nakasone
סביאטוסלאב	sviatoslav
דוריאן	dorian
פורייר	fourier
מיילט	maillet
אטלאנטיק	atlantic
ג'טו	jettou
קנסינגטון	kensington
סלים	slim
סאטו	sato
סיסוקו	sissoko
בירגיוס	bergius
מיקארי	mikari
רחבעם	rehavam
וירילוג	verilog
נאטו	nato
שור	shore
פרידג'וף	fridtjof
שילטון	shilton
בוטליליס	boutlilisse
מאהר	maher
מולר	moller
ג'וסיפז	josephs
מגן	magen
ריומא	ryoma
אמל	amal
ניקולאייב	nikolayev
פייג'	page
היקמאן	hickman
ג'וליאנו	juliano
אוסטראבא	ostrava
באבילון	babylon
סופיאן	sufyan
מלקיאן	malakian
סטאטן	staten
גינאדי	gennadi
מט	mt
מלאדיאן	mlađan
אמורו	amuro
ריקוב	rykov
ראפי	rapp
לינדרות	linderoth
פוניט	ponnet
זוביידי	zubeidi
אזארינקא	azarenka
חארית	harith
באיבארס	baibars
פאניאני	pagnani
הארי	hari
שיילין	shailene
ג'וחר	dzhokhar
מארי	mari
מיסן	meissen
ביליטש	bilic
נייתן	nathan
פרודו	frodo
אירי	erie
פרומיתיוס	prometheus
קורו	curro
מזאלי	mzali
ג'ני	jenni
סיטינג	sitting
פאטיסון	pattison
מיזי	mezey
וולטייר	voltaire
הידיקי	hideki
לאדיסלאב	ladislav
סאקימוטו	sakimoto
פאהרודן	fahrudin
קאהור	cahors
אסטייר	astaire
יושקא	joschka
קרול	krol
פאיטינג	fighting
מאטיס	matisse
האברקורן	haberkorn
קאמו	camus
וינגר	wenger
ג'והאז	juhasz
שפיק	schafik
מיטסובישי	mitsubishi
בראנץ	brandts
גירקאליו	gercaliu
נאקאהארא	nakahara
ואנגארי	wangari
ביטיגא	bettega
קליבר	cleber
מורסאל	mursal
שין	sheen
אדגאר	edgar
באנגקא	bangka
פאריש	parrish
קודי	cody
הילטון	hilton
ארתור	arthur
בארתולומיו	bartolomeu
אזאר	azar
מיאזאוא	miyazawa
טרונדהאים	trondheim
שינטו	shinto
יזיק	jezek
הומנבאד	homnabad
פיליפ	filip
האניבאל	hannibal
מיליס	mehlis
באיזיד	bayezid
שינזו	shinzo
פוקונישי	fukunishi
סאקסאן	seksan
וילטון	wilton
רובין	rubin
ויק	vic
האס	haas
קיט	kit
ואלאס	wallace
הירוהאשי	hirohashi
לוהאנסק	luhansk
טוגאי	tugay
קושיס	kocsis
שינקיצ'י	shinkichi
השומרון	hashomron
אלן	allen
הייפליק	hayflick
סאלפורד	salford
בשיר	bashir
קאסדי	kasdi
אביגדור	avigdor
גראבא	grava
גאנם	ghanem
אימו	emo
הוס	hus
הוראסיו	horacio
אלדד	eldad
בלירי	belleri
סאמטרידיא	samtredia
מנק	munk
סאנדרי	sandri
גאס	gus
גומע	goma
לאמו	lamu
הורסט	horst
אנזו	enzo
גודיסון	goodison
סטיפניי	stepney
פורטונו	fortuno
קריסטיאן	krystian
המינגווי	hemingway
נרמין	nermin
עגב	agab
קאטאלינא	catalina
ראימי	raimi
בני	benni
פדלאן	fadlan
מינאמי	minami
בויאנוביטש	vujanovic
פינטר	pinter
לאנקשיר	lancashire
נורינבירג	nurenberg
נורגיי	norgay
מאסאקי	masaaki
ספיר	saphir
קובון	kobun
אלמנפלוטי	almanfaluti
ימין	yemin
קונסטאנט	constant
חומידאן	homaidan
אנונסיאטא	annunziata
סאסון	sassoon
האלפורד	halford
ריקדו	rikdo
ספירידון	spyridon
קוסטוריצא	kusturica
מירקאטור	mercator
מאטוס	matus
וניס	venice
חמוד	hammoud
פרנאנדו	fernando
אלן	ellen
יאוקון	yaokun
דולצ'ה	dolce
זיי	ziyi
קארולא	carola
לויס	lewis
מלקיור	melchior
לודוביק	ludovic
ואנגצ'וק	wangchuck
קוהארו	koharu
פאראדורן	paradorn
ניקול	nicole
יאנגון	yangon
מורס	morse
יוסף	youssef
דאודורו	deodoro
קריסטנסן	christensen
מאסינגא	masinga
נאבארו	navarro
אפרים	ephraim
סטיבינארד	stievenard
זאמבילי	zambelli
קאבוקי	kabuki
אזאלי	azali
קונטרא	contra
אוליביירא	oliveira
ברמאן	berman
קארלובי	karlovy
לוס	loos
גאן	gan
יורדאניסקו	iordanescu
ג'אואדי	djawadi
קוסטיטש	kostic
לויד	lloyd
מאקסים	maxime
מאסי	massey
חבש	habash
הארטרי	hartree
ג'יבריל	djibril
מומוני	moumouni
מיאזאקי	miyazaki
בגדאדי	bagdadi
גוצאנטי	guzzanti
היסאטו	hisato
הייסטינגס	hastings
קוינטין	quentin
סאדא	sada
כהן	cohen
דקל	dekel
טוקיו	tokyo
בירנבאום	birnbaum
ריצ'רט	richert
נאדא	nada
מאקמאנאמאן	mcmanaman
נילטון	nilton
דאדא	dada
אפרים	efraim
היוגו	hugo
רפי	rafi
לוגו	lugo
מקניל	mcneill
קאפי	kafi
נאפי	nafi
לאנגטון	langton
מוסטובוי	mostovoi
האדזיביגיטש	hadzibegic
חלו	helou
וואלרי	valery
דרימוורקס	dreamworks
גונזאלו	gonzalo
באמבאנג	bambang
יורג	jurg
אלג'אבר	aljaber
דזירי	dziri
חארב	harb
לאנדרו	landreau
קודיצ'יני	cudicini
אפסטין	epstein
רותמאן	rothman
ג'רמאן	german
לוקא	luca
צ'יאקיו	chiacchio
דירבינט	derbent
איזריל	israel
ויסלאוא	wislawa
סטו	stowe
ראמירס	ramires
טירמי	terme
זאכארוב	zakharov
ג'מאלזאדה	jamalzadeh
בארטיז	barthez
האמפטי	humpty
רשמור	rushmore
בולין	boleyn
מאסיג'	maciej
בלום	bloom
פאראמו	paramo
רסיפי	recife
יאסקילאינן	jaaskelainen
סטוקהולם	stockholm
מאסקיראנו	mascherano
הושיאר	hoshyar
סטאתאם	statham
פאנאדול	panadol
גורסל	gursel
הופמאן	hoffmann
זאנטיק	zanetic
אליסיא	alicia
שמאיקל	schmeichel
קוסוגי	kosugi
נאטאשא	natasha
ג'ו	joe
פרייטו	prieto
נוי	noe
וינטר	winter
לוזאטו	luzzatto
גאזי	ghazi
קו	coe
יבון	yvon
שושנה	shoshana
סויטו	soweto
סנטורי	centauri
לאביל	laville
שיפילד	sheffield
ויצ'יני	vicini
ג'רום	jerome
פוטסדאם	potsdam
ליפאין	lepine
טומאס	tomas
סאנדל	sundell
גוקדניז	gokdeniz
יושיטו	yoshito
ג'ונבלאט	jumblatt
קייב	cave
נדביד	nedved
טוראן	turan
סאלבוטאמול	salbutamol
ויג'יטש	vejic
מילר	miller
קיו	kyu
עאמיר	amir
פלורנטינו	florentino
סירגיי	sergey
שפיק	shafik
קדימה	kadima
סויד	sweid
גלאו	glau
סמאש	smush
שוימר	schwimmer
מאניפיקאט	magnificat
סטראטפורד	stratford
מוריץ	moritz
גובו	govou
סמאשנובא	smashnova
רונאלדו	ronaldo
טאיביריאס	tiberius
האטויאמא	hatoyama
רודאקוב	rudakov
סירינגיטי	serengeti
בומא	bouma
רוסטאבי	rustavi
גיזה	giza
נחלה	nahla
פאגאניני	paganini
האיקל	haykel
אנו	anno
טראם	tram
פרוכזאד	farrokhzad
עדואן	adwan
פלאמיני	flamini
דג'יאן	djian
בראם	bram
גימאר	guimard
יאסין	yasin
קוקיצ'י	kokichi
היי	hay
מועואד	moawad
קיי	kay
פורויא	furuya
מיי	may
ביי	bay
קויאבא	cuiaba
אראנא	aranha
גאבילונדו	gabilondo
גוגול	gogol
חשמט	heshmat
אליוט	elliot
פיגמאליון	pygmalion
יאמוסוקרו	yamoussoukro
טאגא	taga
איסקרא	iskra
משעל	meshal
קאסטילא	castilla
גאריבאלדי	garibaldi
סביטלאנא	svetlana
עמרם	amram
גרהארד	gerhard
יוניקס	unix
היספאניולא	hispaniola
קאראבאלהו	carvalho
גאגא	gaga
מארינו	marino
מאנינגר	manninger
ביידאס	beidas
דודאמיל	dudamel
פיודור	fyodor
סונקו	sonko
מסרוב	mesrob
פיט	pete
קאטרינא	katerina
ג'ורג'י	georgy
קילי	kelley
ויבר	weaver
דרוקר	drucker
עוהה	auhah
שאבי	xabi
איגלטון	eagleton
פפאיפר	pfeiffer
רפי	raffi
מאנדל	mundell
מולרי	mullery
פלויד	floyd
טינא	tina
קאי	kaj
קארו	caro
קארלוביטש	karlovic
מיטאל	mittal
מוראט	murat
קארדק	kardec
לאנסלוט	lancelot
טשאמי	tchami
פוקס	fuchs
סוקר	suker
שאן	shan
פוליצר	pulitzer
סוקראטס	socrates
סוסילו	susilo
חאן	khan
מוראד	murad
אברקרומבי	abercrombie
סימשוב	semshov
רייקי	reiki
זין	zinn
פירו	pero
סאלזבורג	salzburg
וודז	woods
מקלובה	maqluba
רוי	rui
נירו	nero
הוי	hui
מג'וס	majus
דרומונד	drummond
מוטהרי	motahhari
קריס	cris
גריס	gris
פוקאטילו	pocatello
קאסאט	cassatt
האידן	hayden
נאזלי	nazli
קירוז	queiroz
ג'אידי	jaidi
ען	anne
נאטאשא	natascha
ואלצר	walzer
סידני	sydney
האימאנוט	haymanot
סניר	snir
דריטאר	dretar
הייקו	heiko
דוסינא	dossena
קולומבו	colombo
גריפית	griffith
מאקדונאלד	macdonald
קריסטוף	kristof
היק	heike
הירטפורד	hertford
ליטבינינקו	litvinenko
לינדלוף	lindelof
לאו	lau
ביהאן	behan
קובו	kubo
וימיטש	vemic
גידימינאס	gediminas
דקטור	dr.
קסינופאניס	xenophanes
קאנפור	kanpur
דומאק	domagk
נאמבו	nambu
יקסיל	yksel
פומפיו	pompeo
וינסלו	winslow
וילשיר	wilshere
סיבאסטיאן	sebastien
עאיל	ayil
האלז	halls
מימון	mimoun
ג'והו	jouhaux
קאפרי	capri
טימושוק	tymoschuk
פורסאית	forsyth
ראמאג'	ramage
נבאהט	nebahat
סרוויט	servet
עסאקיר	asakir
גיד	gide
אשדוד	ashdod
פאטן	patton
לאיונל	lionel
קהרמאנמאראס	kahramanmaras
סימבי	simbi
קורודא	kuroda
אקסום	axum
לינדסיי	lindsey
האו	howe
אמונדסן	amundsen
אדיליاד	adelaide
ג'ורוטא	jurota
פאדיגא	fadiga
סאלכארד	salekhard
ג'אסטין	justine
סאלבא	salva
וולי	walle
דאנר	danner
קאטירינא	caterina
קובלנז	koblenz
וולי	woolley
מיסוט	mesut
שועאע	shouaa
ספארל	sperl
דאדלי	dudley
ליון	leon
פרחי	farhi
קיזלר	czeizler
סירביטוס	servetus
ואלדו	waldo
קנקוני	kankoune
ניקילבק	nickelback
סומאליה	somalia
סילביניו	sylvinho
באמבי	bambi
וולמאר	wolmar
באיקאל	baykal
ספאר	sfar
קילפן	kilpin
לינבוי	linvoy
נובורו	noboru
רינא	rina
דוראן	duran
ספריס	seferis
פאטריס	patrice
מינא	mina
נינא	nina
ברידג'	bridge
דינא	dina
רוש	rosh
סיאגריוס	syagrius
שיין	shayne
הרובש	hrubesch
טיריזא	teresa
ג'וש	josh
סיאנפויגוס	cienfuegos
תלפיות	talpiot
מוטאקי	mottaki
טיריזא	tereza
פיליסיאנו	feliciano
וולאדא	vlada
גוש	gosh
מיו	miyu
איטאלי	italy
קרעון	qaraoun
פאם	pam
סאם	sam
מארצן	marcin
חאם	ham
קאסאי	kassai
חיסוס	jesus
חנבל	hanbal
פרדוס	ferdoos
משולם	meshulam
דאם	dam
אהירן	ahern
קופור	kufuor
קאלא	kalla
דיוגו	diogo
בארמוס	barmos
גרימונפון	grimonpon
קארדוזו	cardozo
הינאן	henan
אראבא	arraba
קאמביאסו	cambiasso
איבריסט	evariste
נפטי	nafti
רוטאנא	rotana
סקארליט	scarlett
פראיא	praia
ויסילינוביטש	veselinovic
בריאן	brian
נסרי	nasri
בורסילינו	borsellino
אם	am
זוקורא	zokora
ראביו	rabiu
קול	kul
סינקלייר	sinclair
מאטיראצי	materazzi
דודקא	dudka
גאנג'אוי	ganjavi
גיבון	gibbon
פול	ful
גול	gul
זאירי	zairi
פרידריק	fredric
דימיס	demis
רבין	rabin
היטון	heaton
סטייר	steyr
פרוסט	prost
קוראקי	kuraki
וייל	weil
ויטו	vito
באראם	baram
מילאניטש	miljanic
איסר	isser
סאבאטיני	sabatini
עמור	amor
טריסט	trieste
קאפונ	capone
סאלאמאנקא	salamanca
זילינקא	zelenka
שישאקלי	shishakli
צ'ומי	tschumi
טריביטש	trivic
פרליטו	ferlito
ליברטאדוריס	libertadores
לומומבא	lumumba
ניימינין	nieminen
ראיטש	reitsch
דונאלד	donald
אלאיספהאני	alisfahani
טוקיו	tokio
ביניש	beinisch
אסקיל	eskell
פול	poll
פייזון	faison
הול	holl
טומילו	tumelo
ברי	bree
טרייל	trail
ווטריך	wuthrich
ג'ירי	jiri
קירי	kiri
גול	goll
שארמא	sharma
טילדא	tilda
קריסטוף	christoph
בולן	bohlen
מלקי	melki
נואה	noah
קלאודיו	claudio
סייד	sayed
יוסו	juuso
קימפס	kempes
האואי	hawaii
ראנסום	ransome
בוריל	burrell
ג'ון	john
קון	kohn
נורי	norrie
ריבירוס	riveros
מיקימוטו	mikimoto
הומילט	hummelt
אספראנטו	esperanto
בירטוס	bertos
הדי	hedi
טביר	tver
היגל	hegel
נאיף	naif
לאברא	lavra
ניקולאוס	nikolaos
פיסטויא	pistoia
קשמיר	kashmir
בדי	bedi
סנדהיל	sendhil
הינטרמאיר	hintermaier
מאקנרו	mcenroe
מארטא	marta
שאמלו	shamlou
אלאהראם	alahram
פיליפס	philips
קולמאר	colmar
סינדירוס	senderos
יאקושין	yakushin
גאליאצו	galeazzo
דרו	drew
פייטרו	pietro
רובי	robbie
פיגארו	figaro
יורופא	europa
סאמפי	sampi
ריו	ryo
בורגיטי	borgetti
יורגנסן	jorgensen
ויסטרמאן	westermann
וילקי	wilkie
סאצוקי	satsuki
גירמאניום	germanium
טוביטא	tobita
דלפינו	delfino
סייאבונגא	siyabonga
קארנגי	carnegie
נינאד	nenad
סבאסטיאו	sebastiao
פאראגואי	paraguay
דלימכאנוב	delimkhanov
גימיי	gemmei
סילבא	silva
וודגייט	woodgate
רוטל	ruutel
בוזאניטש	bozanic
יוזו	yuzo
גאלוא	gallois
קורי	corrie
הילדי	hilde
קונינגהאם	cunningham
סארוכאן	sarukhan
טאשירו	tashiro
לאפורטא	laporta
ואדוז	vaduz
טיסיליוס	tiselius
טאגור	tagore
ואילד	wilde
בושעיב	bouchaib
בילסא	bielsa
גריי	grey
זירסיז	xerces
מוג'יטש	mujic
מקארתי	mccarthy
טו	tuo
אלה	ela
מאיקלאנג'ילו	michelangelo
ג'ניפר	jennifer
מאימון	maimon
אירוס	eros
פופיסקו	popescu
דואו	duo
איקידו	aikido
קאנסאס	kansas
ווריאדיס	voreadis
סוגיטא	sugita
אשרף	ashraf
יאנסינס	janssens
מאזארין	mazarin
שאקירא	shakira
סאנדרא	sandra
סילקווד	silkwood
קלינת	cleanth
פוג	fogh
גוג	gogh
אוליבירו	olivero
ליפומא	lipoma
קארלא	carla
לורדאן	lordan
צבי	zevi
בוטהאר	boutahar
לוסיל	lucille
פייראנגלו	pierangelo
נאבי	nabih
סינדי	cyndi
בוינוס	buenos
ציפו	tsepo
מאריופול	mariupol
ליואי	levi
רודריגיז	rodriguez
קוסטרס	custers
פנלון	fenelon
אזילאל	azilal
ברושיטש	brocic
טאוט	taut
קויזומי	koizumi
דומיניק	dominique
שוארצר	schwarzer
דאקורט	dacourt
בארטולוצ'י	bartolucci
יאסין	yassine
רול	rool
פאלאסיו	palacio
נטפים	netafim
וקסלר	wexler
באזאני	bazzani
יאנקוביטש	jankovic
ברנייז	bernays
הורט	hurt
תיודורא	theodora
קארלסון	karlsson
קאנטרברי	canterbury
בשארי	bsharri
שמיט	schmitt
בורט	burt
ויבינג	weaving
מילבא	milva
טארליב	tarlev
מאקינדו	mcindoe
גראסי	grassi
שירביוס	scherbius
קאטאיאמא	katayama
ליפמאן	lipmann
קולומאן	koloman
איקיבאנא	ikebana
פוקודא	fukuda
מישל	michel
שולמית	shulamit
ז'קוב	zhekov
מיקאל	michal
צ'ילמבי	chilembe
לחזאמי	lahzami
שלמה	shlomo
רינקוין	renquin
לומביני	lumbini
נאטאלי	nathalie
אינקא	inca
ברק	barack
קאטסוקי	katsuki
יאן	yann
מישל	michelle
דולמאנז	dolmans
דייגו	diego
אוראנוס	uranus
נאטאפורן	nattaporn
תאצ'י	thaci
לארס	lars
מאראנהאו	maranhao
בני	bnei
קונשיטא	conchita
ג'ורבאן	jorvan
פוטשיטינו	pochettino
סופוס	sophus
בארדסלי	bardsley
מאסיאס	macias
קאקלאמאנאקיס	kaklamanakis
סיבאסטיאן	sebastian
ריסקין	riskin
דהאן	dahan
פיק	peck
דיכטר	dichter
ספארטא	sparta
רימבו	rimbaud
סראישאפאן	srichaphan
מחמד	mehmed
סיפי	sifi
ברודי	brodie
בראגא	braga
באריסון	barison
יוסף	yosef
קיז	kees
זאק	zac
פיפי	fifi
ויסניסקי	wisnieski
שומו	shomu
הירש	hirsch
זולטאן	zoltan
קופירין	couperin
קולומביא	colombia
מאק	mac
קאלדירון	calderon
האוסדורף	hausdorff
מאסילילא	masilela
מפינזא	mpenza
גויאם	guillaume
פרידיריק	frederik
אדריאטיק	adriatic
מירני	mirnyi
האינז	heinze
גרין	green
איאקוינטא	iaquinta
קואשי	quashie
ג'וזפין	josephine
סאנשיז	sanchez
גליסין	glycine
סאניי	sanae
אפוקאליפטיקא	apocalyptica
קאנדיא	kandia
שון	shaun
לוקאס	lukas
הלסינקי	helsinki
סיקו	seko
טיקו	teko
אולד	old
איסקיטים	iskitim
בורדון	bordon
רחימה	rehema
בורדין	bordin
ליקו	leko
יארד	yard
שאמי	schami
שיבינינגן	scheveningen
מישא	mischa
גוגוש	googoosh
דבי	debbie
הארבי	harvey
קיזאנישבילי	khizanishvili
וורד	ward
הארד	hard
סמיליאניטש	smiljanic
שוקט	shawqat
אלמידא	almeyda
מקסטיי	mcstay
קורטין	curtin
טרנאבא	trnava
סואגארט	swaggart
טשומוגו	tchomogo
קוברמאנס	koevermans
טיד	tedd
שאוקאט	shawkat
קויני	queeny
ויסנטה	vicente
פראהאני	farahani
עמנואל	emmanuel
האנזו	hanzo
ויי	veii
מחרוס	mahrous
בורטן	burton
במקום	bimkom
דאניילסן	danielsen
היאמא	hiyama
ארונסון	aaronsohn
ואראיו	varallo
מהרדאד	mehrdad
קלינטון	clinton
גורדון	gordon
רויטר	ruiter
קאירו	cairo
רמי	remy
אשדאון	ashdown
סאבו	savo
גונזאלז	gonzalez
ברגרין	berggreen
לאטימר	latimer
פפיסטר	pfister
ואצלאב	vaclav
הוטשינסון	hutchinson
תיראווסין	theerawesin
פלורינט	florent
מנגומיני	mngomeni
טודיק	tudyk
תיסיגר	thesiger
ג'אניוני	giagnoni
פרוקופ	prokop
ברנאר	barnard
יזיד	yazid
קומאלו	khumalo
מולילו	mulilo
בוטרוס	boutros
מולינא	molina
מיאטא	miyata
גייל	gael
פיריירא	ferreira
סטיפן	steffen
סילביין	sylvain
בורונדי	burundi
פנחס	pinhas
פראשא	prussia
פנום	phnom
ראגב	ragheb
דידרו	diderot
מירקורי	mercury
לוליטא	lolita
בוכנר	buchner
אמידיו	amedeo
מנאף	manaf
טאקישי	takeshi
ברצ'לינו	bercellino
האן	haan
ראמספילד	rumsfeld
באליסטיק	ballistic
קירסטן	kirsten
בנט	bennett
נאן	naan
ליטל	little
בהראמי	behrami
מאקונין	makonnen
מארקס	marx
קאן	caan
שוסטר	schuster
אמדן	emden
בלאקסטון	blackstone
קיריצ'נקו	kirichenko
אפולינאריס	apollinaris
חמדאן	hemdan
סטולטנברג	stoltenberg
באטלר	butler
טאדיראן	tadiran
לאטביא	latvia
פוזי	posey
סרינאגאר	srinagar
חוואטמה	hawatmeh
פרוסט	frost
ולאסיטש	vlasic
נוזומו	nozomu
אני	ani
ניאל	niall
ברוניי	brunei
סטינדארדו	stendardo
אשכנזי	ashkenazi
זאניטי	zanetti
קפורי	kfoury
הורנא	horna
ג'וספאן	jospin
הורן	horne
קיומין	cumin
פלורין	florin
מוחמד	mohammed
ליפטין	leptin
נאזיק	nazik
קידו	kido
קוגיוקו	kogyoku
הידינק	hiddink
קוטו	couto
ג'אפ	jaap
פונטיס	pontes
סטוקר	stoker
ונדי	wendee
וירץ	wiertz
בוינסק	buinsk
סלובאקיא	slovakia
פאראמור	paramor
איבאנז	evans
פילי	pelle
קלקטא	kolkata
רותליסבירגר	rothlisberger
פילי	pelli
סיבוסיסו	sibusiso
דאגסטאן	dagestan
דראגניא	dragnea
שיבאטא	shibata
ליון	lyon
פאזדאן	pazdan
קארוה	qaruh
ויטאלי	vitaliy
מאקקוין	mcqueen
איג'אקס	ajax
זאקר	zucker
גרונביין	grunbein
מוחארם	muharram
איברסון	iverson
היראקליטס	heraclitus
טריגבי	trygve
חואנדי	juande
קאנטונא	cantona
סטראסיר	strasser
חריסא	harissa
דוהאמל	duhamel
רודולפו	rodolfo
רוזנבלאט	rosenblatt
קדירוב	kadyrov
לורנא	lorna
קאמיל	camille
קאפור	kapoor
פיולין	pioline
רומולו	romulo
מאדירנו	maderno
פולי	puli
פושקין	pushkin
פומיו	fumio
תימבנקוסי	thembinkosi
ויניזיא	venezia
אמרסון	emerson
טאפר	tafer
הוסקינס	hoskins
בוזולג'אק	bozoljac
נאגמא	nagma
ערפאת	arafat
אדלר	adler
לינדי	lynndie
חודאדאד	khodadad
לאזארו	lazzaro
מאקסמליאן	maximilien
מקביל	mcbeal
אפולו	apollo
לאקארן	lacarne
חאראן	haran
קלינג	kling
שינריקיו	shinrikyo
איברי	ivry
מוסקאט	muscat
סילבא	sylva
ג'ואקים	joachim
מיריד	mairead
קופנהאגן	copenhagen
מורטי	murty
מילביל	melville
ראיזיגיר	reiziger
ראטקו	ratko
הונשו	honshu
וודקוק	woodcock
פראנסילודו	francileudo
פיטרא	petra
גואדלופ	guadeloupe
ארטימיס	artemis
פיטרי	petri
פיאלא	fiala
אבולי	eboli
פופלוהאר	popluhar
מאנינג	manning
וד	oued
מנאג'ד	mnajed
סאנאדר	sanader
שיראק	chirac
שאדלי	chadili
מיתיין	methane
יונגהאנז	junghans
הוליס	hollis
טרשקובא	tereshkova
נוריקו	noriko
פודיסטא	podesta
סן	sen
גי'ולוג'י	geology
סאיפרוס	cyprus
פאולינא	paulina
לן	len
מן	men
ג'וליאני	giuliani
רובינג'	rovinj
ואלקירי	valkyrie
שאפוזיו	chappuzeau
וודרו	woodrow
מבו	mbo
מינגיו	mingyu
פולי	polly
דוריגו	dorigo
אפרת	efrat
היטינגא	heitinga
סאיביט	saivet
פים	pim
בליטונג	belitung
ג'ים	jim
קים	kim
לודוביקו	lodovico
מארקו	marco
נוגלי	nogly
סיפי	seppi
טולידו	toledo
ליקנז	leekens
קונדוליזא	condoleezza
סואזילאנד	swaziland
הופירט	huppert
בודאן	bohdan
רומל	rommel
זיטקא	zitka
מג'די	mejdi
סוג'ורנר	sojourner
האריאנא	haryana
סו	su
לוסיו	lucio
בו	bu
אלדייר	aldair
ליונור	leonor
תיופאניס	theofanis
פלוריאן	florian
לוסיא	lucia
אסן	essen
גלובר	glover
קלינט	clint
צ'יימברלין	chamberlain
שירידאן	sheridan
אדוארדז	edwards
ואלט	walt
ג'וסף	josef
קילי	kelly
חאוי	hawi
פורסטר	forrester
לותר	luther
זוביזאריטא	zubizarreta
בולה	bulleh
לינדבאי	lendvai
סיפירט	seifert
לוטא	lota
בלוטגן	bluitgen
צ'אנל	chanel
סטורט	sturt
חסין	hsien
רוטרדאם	rotterdam
רובן	robben
הארטמאן	hartmann
שיטו	shittu
טומאסו	tomaso
אדוניס	adonis
בלמונט	belmont
מינאמוטו	minamoto
ג'והאנסברג	johannesburg
ואליטא	valletta
קוראדי	corradi
טאיביריאס	tiberias
תלמוד	talmud
באסטיאן	bastian
יאניס	yannis
פלוריאנופוליס	florianopolis
רולו	rollo
נובל	nobel
ביסמארק	bismarck
טורק	tork
דרסדן	dresden
דינייאר	diniyar
היליבויק	hellebuyck
מוארווארי	mwaruwari
ראאף	raef
בורק	bork
הורוביץ	horowitz
באטיסטא	battista
טירנאניטש	tirnanic
טוטמא	totma
צ'ימבונדא	chimbonda
יעקוב	yacob
היצפילד	hitzfeld
לאזיו	lazio
הולי	holly
סוניס	souness
קרירי	kariri
קרימי	karimi
פאלאו	palau
רובינהו	robinho
פאיול	fayol
היביסאיד	heaviside
דמיטרייב	dmitriev
פרמאן	firman
ג'יים	jame
לאנאנרק	lanark
נלי	nelly
קסיר	kassir
ריצ'י	richie
בי	bea
וזניאק	wozniak
מאיורקא	majorca
מאדונא	madonna
לאודרופ	laudrup
ברין	brin
בירנז	burns
תג'וויד	tajwid
דארסי	darcy
פאראדיסו	paradiso
מאילי	miley
סאסאקי	sasaki
סאייד	sayyid
מינאגאוא	minagawa
רוסדיסקי	rusedski
קראדוק	craddock
טאימא	tayma
דילא	della
סרסור	sarsur
בונגארץ	bongartz
הלוי	halevy
אדי	edie
שיפמאן	shipman
זקריא	zakaria
יאזאלדי	yazalde
רינאלדו	reinaldo
מאסאשי	masashi
גנאם	ghannam
שמשון	shimshon
מאלכאז	malkhaz
ואטארו	wataru
קאניגיא	caniggia
קראנוסיטש	karanusic
פירל	perl
אגוילירא	aguilera
גוצ'יון	guccione
דארוי	darui
מונט	montt
היינימאן	heynemann
קאניטי	canetti
טאמפא	tampa
בירל	berl
בילא	bella
אביבי	abebe
ניוסטד	newsted
מונטי	monti
בלו	bello
מונטי	monte
טסוטומו	tsutomu
פילסנר	felsner
אירהארט	earhart
נזיף	nazif
מאיא	maya
ז'ו	zhou
ואלדהאים	waldheim
קאליגולא	caligula
נאזים	nazim
טלאל	talal
נאציז	nazis
סאיז	saez
ליובומיר	ljubomir
וינסון	vinson
סאלאס	salas
סאלאר	salar
סרור	srur
קורוטורק	koruturk
פורט	fort
דיגוק	degauque
ערא	ara
בראמאנטי	bramante
הלוי	halevi
תיו	thio
סיבירוס	severus
לוינסקי	lewinsky
טומוקו	tomoko
לאבואזייה	lavoisier
גרוסמאן	grossman
אלאוישס	aloysius
אוהיו	ohio
פאלטרמאיר	faltermeyer
ואסארי	vasari
גיליאד	gilead
מיקאליס	michalis
הילמוט	hellmut
ליסט	list
דורסן	dorsin
סאנדלר	sandler
יוריאקו	yuryaku
סוסיטש	susic
ראמו	rameau
קאריני	carini
פליסירז	plessers
איתמר	itamar
מאסאמי	masami
בקר	bakr
מאסאקי	masaki
ריזיק	rizik
בחמדון	bhamdoun
מארקו	markku
רינאטו	renato
בוריאטיא	buryatia
רומייניאנז	romanians
אולמאן	ullman
פאפין	papin
גwאני	gianni
מנדונקא	mendonca
באקיר	baqir
בראהמא	brahma
נוברי	nobre
האוולז	howells
באלוטא	ballotta
מנחם	menachem
סוק	souk
ראיקו	rajko
ג'ורקאס	giourkas
סושי	sushi
קארי	carrey
קיני	kinney
האקאבי	huckabee
אליסטיר	alistair
רואידא	rouwaida
האנדלר	handler
חניף	hanif
מוטארילי	mutarelli
סאנגויני	sangweni
גליסון	gleeson
מאלקולם	malcolm
עבאדי	ebadi
ואניס	wanis
פאגאני	pagani
נומביטי	nomvethe
פרידריקסון	fredriksson
קורדל	cordell
ג'אקה	jacquet
פירס	pearce
סין	sinn
קאריוקא	kariokka
וין	winn
טאהיטי	tahiti
מיטרופולוס	mitropoulos
מורוי	mauroy
לין	linn
סלאווניא	slavonia
לאברונינקו	lavronenko
ג'אבר	jaber
קיסיליוב	kiselyov
נד	ned
פראדו	prado
פין	finn
קובנטרי	coventry
ראבא	rabbah
ליון	lyonne
חוסו	josu
ויליס	willis
וארנוק	warnock
פאולא	paula
פלימינג	fleming
קינזי	kinsey
סאלי	sali
לייליי	leilei
חאטם	hatem
ידין	yadin
סעיד	saeed
קאראגר	carragher
ניפס	niepce
מאמט	mamet
פרלמאן	perlman
חלילילו	kalililo
עקבה	aqaba
פורמוזא	formosa
ואלש	walsh
ואלירי	valeri
פאזיו	fazio
אדם	adam
פרייזר	fraser
נפזי	nefzi
סאמי	sami
קייזו	keizo
איילה	ayala
הארלאן	harlan
מושיו	moshoeu
קאמפף	kampf
מאדרוצו	madruzzo
גוניטשירו	junichiro
ניבולא	nivola
טיבט	tibet
רקפי	rexhepi
מוסאמפא	musampa
רוסיני	rossini
קאלאטש	kalac
דיקפריו	dicaprio
אוגוסטו	augusto
אטנבורו	attenborough
שזר	shazar
קלאנסי	clancy
יוגיין	ugyen
דיטריך	dietrich
מאטיו	mateo
ריהאגל	rehhagel
עסאף	assaf
ונטוורת	wentworth
וייד	wade
הונקה	hunke
קומודו	komodo
קישימוטו	kishimoto
גאזפרום	gazprom
רוגיריו	rogerio
בסמה	basma
בראגאן	barragan
קנוט	knut
שמה	shamma
ג'אניס	janis
דודומא	dodoma
מונאיטיס	munitis
קוהייד	cohade
מוניקא	monica
טומארט	tumart
בטאטו	batatu
זועבי	zuabi
שומאן	schumann
אונו	aono
בונו	bono
מאהוט	mahut
מאדירא	madeira
מארלון	marlon
עיסאם	isam
ראדואנסקא	radwanska
בריטשיט	brechet
האהניל	haehnel
רושדי	rushdy
מיני	minnie
מאגלאן	magellan
ג'ויס	joyce
ברלסקוני	berlusconi
לוק	luc
גיבז	gibbs
אליהו	eliyahu
צ'ויקוב	chuikov
האניס	hannes
מארון	maron
מרום	marom
שמונה	shmona
ברוק	brook
קאטב	kateb
סארוט	sarraute
מארוק	maroc
שדרות	sderot
סינג	singh
מצלדר	metzelder
ויסי	vesey
נסטא	nesta
ולהא	velha
דאנשוור	daneshvar
לאמבריכטס	lambrichts
סאויריס	sawiris
עותמאן	uthman
שינאואטרא	shinawatra
מאהיאדי	mahyadi
וונגלוס	venglos
האטורי	hattori
מלחו	melho
אינגמאר	ingmar
קארלסן	carlsen
גוילירמו	guillermo
אמי	emmy
גבעת	givat
אסנא	esna
זימרמאן	zimmerman
קוצ'אק	kuszczak
קארול	karol
עסאם	essam
סגא	sega
דורותי	dorothy
טאליבאן	taliban
איז'א	asia
סטיפן	stephen
אייי	iii
בראד	brad
קאזאכסטאן	kazakhstan
דלאל	dalal
ואלנטינו	valentino
גיורגיוס	georgios
חאטר	khater
ואלנטין	valentine
קורסיטי	corsetti
מור	more
דאניא	dania
האדוק	haddock
האניגאן	hannigan
הילפמאן	helpman
סאואשירו	sawashiro
מוקייזי	mukasey
קאמפס	camps
קלימנט	kliment
רמזאן	ramzan
טימברלייק	timberlake
זאפור	zafour
לוקאס	lukasz
מיג	meg
בנאזיר	benazir
קאניו	canio
קאטליגו	katlego
מאנדאלא	mandala
זבי	zvi
גאבר	gaber
דראגילא	dragila
פאיאד	fayyad
דומינגו	domingo
ברטולט	bertolt
קרומוול	cromwell
אייסיס	isis
נחום	nahum
קרב	krav
קירזהאקוב	kerzhakov
באנדלר	bandler
פאסקואליטי	pasqualetti
ג'ורג'י	georgi
באמר	bammer
בוזארה	bouzarah
פולק	pollak
דיימוס	deimos
נאטאליא	natalia
פהמי	fahmi
קיסט	kist
ג'ייקוב	jacob
בקי	baecke
ואזאן	wazzan
מורגנר	morgner
וינצ'ינזו	vincenzo
פלאסנטי	placente
נאבאס	navas
טראנסאט	transat
ביסמילה	bismillah
קלאמפיט	clampett
ראטב	rateb
הולודומור	holodomor
רוון	rowen
פוסלי	fuseli
קוטארו	kotaro
ואנגיליס	vangelis
ט	t
קאיומי	kayumi
סאקאמוטו	sakamoto
קונסטאנטא	constanta
אסאטיאני	asatiani
מוג	moog
גנים	ganim
סאבאו	sabau
סאבאט	sabat
טאראנטינו	tarantino
אף	f
מאשין	machine
עאטף	aatef
מילאד	milad
פיקאלסטו	pykalisto
מרג'אן	marjane
טאדיטש	tadic
יאקין	yakin
ג'אנלויג'י	gianluigi
ג'ואו	joao
בישר	becher
ברונר	bruner
יאניס	yiannis
גאניס	ganis
בורקהארט	burckhardt
מקלין	mclean
סאדיק	sadiq
בינו	benno
סבאח	sabah
רונדוניא	rondonia
סביטקוביטש	cvetkovic
דלהי	delhi
בלייק	blake
קוילמאנס	ceulemans
ראזבאן	razvan
שו	shaw
בני	benny
דאריל	darrell
דאר	daar
גזאל	ghezal
סיקטיבקאר	syktyvkar
גאלוואני	galvani
סומא	soma
שנאידר	schneider
ראבח	rabah
דימיצ'לאס	demichelis
לידיא	lydia
מאג'וסקי	majewski
מיהובי	mihoubi
שינקאנסן	shinkansen
יארטסיב	yartsev
טביליסי	tbilisi
מגני	meghni
לוטון	lawton
בארבור	barbour
אוגסברג	augsburg
גנאקו	gnako
מורו	morrow
לאסקארינא	laskarina
טמבל	tambal
קאפלינסקי	kaplinsky
וארנהאגן	varnhagen
סטיפ	stipe
עבדאללה	abdullah
ראימאן	reimann
הוקוסאי	hokusai
בריז	breeze
סיבירו	severo
קין	keane
פאלאניוק	palahniuk
סדאם	saddam
רודני	rodney
למיאגרי	lamyaghri
לואק	loic
ג'יימי	jaime
וארהול	warhol
דראגאן	dragan
בן	benn
גינשו	gensho
מבאמבא	mbamba
ואטרוס	watros
ואסרמאן	wasserman
רודזיק	rodzik
סויר	soyer
שי	shay
וישניבא	vishneva
אמאנדא	amanda
לנב	lenev
גימי	gimme
שריקי	shriki
ויטמאן	whitman
קארטאגינא	cartagena
נסים	nessim
חדיד	hadid
מסעוד	massoud
פורטר	porter
מפילא	mphela
מירון	miron
ואדיח	wadih
פאטון	fatton
נאוהירו	naohiro
גרין	greene
ואלנסיא	valencia
קורבט	korbut
הוסיטש	hosic
ודיע	wadie
לוגופיט	logofet
סאלבאטורי	salvatore
קורבוסייה	corbusier
לך	lech
יאמאדאייב	yamadayev
לאינוס	linus
צ'ק	cech
אדאן	adhan
ואדים	vadim
זאלאייטא	zalayeta
ביבר	biber
פירינק	ferenc
אוקטאביו	octavio
נובל	knobel
קירוב	kirov
קואנזא	kwanzaa
לוקארילי	lucarelli
דיאמאנטינו	diamantino
זרואלי	zerouali
נאקאמאצו	nakamatsu
ג'אסיק	jacek
לבן	laban
הארדאויי	hardaway
ג'נסן	jensen
דזורינדא	dzurinda
בינגו	bingu
טופאל	topal
טוניס	tunis
אסונסיון	asuncion
ליר	lear
קוים	quim
סובורוב	suvorov
לילינטאל	lilienthal
מאיקלז	michaels
מארזל	marzel
קואליארילא	quagliarella
סלימי	sellimi
אקרובאט	acrobat
ברטין	bertine
מאדלונג	madelung
זאגאלו	zagallo
זדיניק	zdenek
ואסאראס	vassaras
סארא	sara
צ'וטוס	choutos
ואנג	wang
מאנין	mannin
איטורי	ettore
גאליסי	gallice
פרינסס	princess
טאטי	tati
לימאסול	limassol
סאנדרו	sandro
נוריזאן	norizan
דודאייב	dudayev
מאטרלינק	maeterlinck
אדוין	edwin
שלוסברג	schlossberg
עמיחי	amichai
בודו	bodo
בראנדו	brando
זגארטא	zgharta
טוטאל	total
מידוריקאוא	midorikawa
קארארא	carrara
ג'וסיפ	josip
קליבלאנד	cleveland
שיבא	shiva
נוביל	neuville
מילט	milt
עטאר	atar
קיצ'י	kiichi
היפיסטוס	hephaestus
פרנאנד	fernand
עזרא	ezra
גוטאמא	gautama
דאנילו	danilo
ואתיק	wathiq
מודיבו	modibo
זוהיר	zuhair
דיסקין	diskin
קאטונגו	katongo
גראינדר	grinder
הוארי	houari
רוסטום	rostom
וסילין	veselin
אליוט	eliot
פוזי	fusi
סיזיפוס	sisyphus
פאמקי	famke
גונזאגא	gonzaga
נאדיא	nadia
גילז	geels
גורינג	goring
טוטורו	totoro
ראיט	wright
שיגירו	shigeru
נדיר	nadir
סקיריט	skerritt
מאריסא	marisa
ריביסי	ribisi
גריגוריו	gregorio
קריסטא	christa
זאבאליטא	zabaleta
ג'וס	jos
מאריקא	marica
הידיאקי	hideaki
סטייניץ	steinitz
אגרנט	agranat
פיוריא	peoria
רוני	rooney
חיג'אזי	hijazi
וראק	warraq
סיינפילד	seinfeld
סוברין	suvrijn
בלונדו	blondeau
האדלסטון	huddlestone
דופרי	dupree
קארפינסקי	karpinski
יאקופו	jacopo
האיאשי	hayashi
ג'יהאד	jihad
הירשפילד	hirschfeld
שירנגהאם	sheringham
דרינטה	drenthe
פירייה	ferrier
סלימאן	slimane
בונקול	buncol
ליכוד	likud
טראביאן	travian
בודי	budi
ואגיז	vagiz
דודי	dudi
טומאס	tomasz
פאיתון	python
אלאסד	alassad
מאקאוליף	mcauliffe
ג'וזיף	jozsef
מאנויל	manuele
קודינא	codina
היראקליס	heracles
קריסטוב	christov
האם	hamm
מידורי	midori
אלקטרא	elektra
סאבאטו	sabato
האקינן	hakkinen
סורינטו	sorrento
דנקטאס	denktas
איבו	evo
באלנטינא	valentina
טומיי	tomei
ריביר	revere
באדר	badir
קלאינירט	kleinert
מאג'יק	magic
רים	reem
נייסמית	naismith
מצודת	metzudat
מארקיטו	marchetto
מיסטר	mr.
גאון	gaon
הודיא	hoodia
מיטשירו	michiru
פראנסיסקולי	francescoli
פאטן	faten
עבוד	abboud
קאנון	cannon
סורבייר	suurbier
מובי	movie
האוסמאן	hausmann
היוטון	hughton
אנימאניאקס	animaniacs
נירירי	nyerere
גרנמייר	grnemeyer
סילבסטר	sylvester
ניקופולידיס	nikopolidis
מישיגאן	michigan
אקונומיסט	economist
מוסלים	muslim
לירו	leroux
סטירלינג	stirling
סירגינהו	serginho
דייוידז	davids
קאקורו	kakuro
רימיטי	rimitti
קלוס	klaws
תיודוריק	theodoric
צ'סטר	chester
גראבאר	grabar
הוטון	houghton
ריאד	reyad
טוגו	togo
פיריז	perez
דאיוו	daewoo
חקמט	hikmat
פרק	perec
חיקמט	hikmet
צור	tzur
ליבאר	libar
נמיירי	nimeiry
מונרו	monroe
היטושי	hitoshi
באסבי	busby
ג'ואקין	joaquin
סטיטש	stech
סירין	serine
מאקס	max
מורו	moreau
האנקי	hanke
הימאטוקריט	hematocrit
יוהאן	johann
קסיאנג	xiang
גיצ'י	giichi
האדג'נז	hudgens
סיהאוונג	seehawong
וילאריאל	villarreal
יאפא	yafa
הישאם	hisham
מאסאיא	masaya
פרוטוקול	protocol
פטרופוליס	petropolis
רואן	rowan
קורנייב	korneyev
נפאע	nafa
קאמירון	cameroon
מזהר	mazhar
שלום	shalom
מילאן	milan
קארל	karle
טוב	tov
קוליט	collette
בירגיט	birgit
לבינג'ר	levinger
ביזוס	bezos
גולבנקיאן	gulbenkian
פאנריט	phanrit
נובין	novin
סטור	stoor
רוברטו	roberto
ג'והר	johar
היגז	higgs
שטאינמאיר	steinmeier
בורקינא	burkina
בקנבאור	beckenbauer
ליפטון	lipton
פאטמוס	patmos
לינוקס	linux
אימיריטי	imereti
קיפלינג	kipling
גריס	greiss
אבאביל	ababil
דון	dunne
בניטו	benneteau
דותן	dotan
גאסקה	gasquet
דאימיו	daimyo
הייס	heyse
אשקרופט	ashcroft
ריטסוס	ritsos
בובלה	buble
בונין	bunin
ג'יין	jane
ואילדר	wilder
ויקטוריא	victoria
אלמור	elmore
קריסטיאנסאנד	kristiansand
עדנאן	adnan
וינסליט	winslet
אינמארסאט	inmarsat
סטאנלי	stanley
קוסטאס	kostas
האסלר	hasler
פירסיפוני	persephone
תוסנד	thousand
ואליסא	walesa
קיטון	ketone
ג'ומיי	jomei
אנדריס	andres
זימרמאן	zimmermann
מונטאלי	montale
גיורגי	gyorgy
הארטניט	hartnett
פוסטי	fuste
ספאיקר	spycher
טמפלהוף	tempelhof
פאטוקא	patocka
הנקין	henkin
מיליצ'יפ	millichip
היום	hume
סיביליא	siviglia
קאיאפאס	kaiafas
ויצמן	weizmann
באלירא	valera
קולומבייה	colombier
פריסקוס	priscus
אמאנואל	emanuele
ויסיטור	visitor
קליופאטרא	cleopatra
טולגא	tolga
מינסק	minsk
סאנגויניטי	sanguinetti
קלישי	clichy
זאמורא	zamora
ווגנר	wegener
ברינט	brent
מליסיא	melissa
זהא	zaha
סלטיקס	celtics
פולאנצאס	poulantzas
בורדה	bordet
סאהא	saha
טאהא	taha
בריס	bresse
קובאטשיביטש	kovacevic
גארדנר	gardner
ארינד	arend
לערפאוי	larfaoui
ויטני	whitney
קארליבאך	carlebach
פראנטיסק	frantisek
ולטאבא	vltava
הירניטש	hernych
האידונג	haidong
יוסף	yusef
אלמג'יד	almajid
מונרוביא	monrovia
קאג'י	kaji
דרויש	darwish
נאג'י	naji
מאקדירמיד	macdiarmid
מארצ'ינא	marchena
יאפינג	yaping
מעלוף	maalouf
קארירו	carrero
דיאקיטי	diakite
ורד	vered
קארלי	carly
שעבי	chaabi
חואנא	juana
דים	demme
באטיסטא	batista
ראמפאל	rampal
קאפקום	capcom
פרומיתיום	promethium
פטיס	pettis
סטיפאניסקו	stefanescu
האני	hany
תיודורוס	theodoros
אלימאן	aleman
דוקס	dockx
סימיטש	simic
רייג'ירו	reijiro
דיזירה	desiree
ריזק	rizk
קאזוהיקו	kazuhiko
טוני	tunney
אמילי	emily
סאלבאדור	salvadore
לואיז	louise
יאהיל	yahel
סילקירק	selkirk
גורקי	gorky
סימאן	seman
נפרטיטי	nefertiti
מאקונאהי	mcconaughey
פאסיפיקו	pacifico
טסאריב	tsarev
ניפטון	neptune
לאמבורד	lambourde
פוריסט	fourest
ליובליאנא	ljubljana
סיאטל	seattle
דימיטאר	dimitar
קירוס	kyros
מיק	mick
דימיריל	demirel
ג'יאניס	giannis
נונו	nuno
מארטינא	martina
רוזאלינד	rosalind
נינומיא	ninomiya
טיוטיהואקאן	teotihuacan
מקויסט	mccoist
בושארדיו	bouchardeau
ליבורנו	livorno
סאלדאנא	saldana
סאורא	saura
עקל	aqel
פורפיראר	pourpirar
סאדאקו	sadako
הודנה	hudna
סאמוסא	samosa
פוזו	pozo
שירי	shiri
נורדבייט	nordtveit
קרודאפ	crudup
קוזו	kozo
קנות	knuth
סימון	simone
לימארי	lymari
היירו	hierro
דוניץ	donitz
קיוטאקא	kiyotaka
קורנה	cornet
מארינקא	marinca
זאמביזי	zambezi
ביואל	buell
אש	ash
בירג	berg
אריק	arik
בריק	brik
ואינהאוס	winehouse
פאקיטא	paqueta
ניו	niue
אנדיומי	indiumiii
ג'אקסון	jackson
לוסאקא	lusaka
דולבי	dolby
מוטינהו	moutinho
קאנירא	caneira
מי	mee
עטיה	attia
גלעאד	gilad
נאיהום	naihoum
ודל	weddell
גומיז	gomez
קוינסלאנד	queensland
קאלי	khali
שהיד	shahid
קריסטובאל	cristobal
קאפיי	kappei
מיריל	meryl
מידאני	meidani
סיאק	sjaak
ניריו	nereo
טולאמור	tullamore
בשיר	besheer
ואנדנדייל	vandendaele
קטר	qatar
קובאלא	kubala
מאלבראנק	malbranque
בירגירו	bergeroo
מאנזוני	manzoni
ואקאטסוקי	wakatsuki
סאנדי	sandy
בינוש	binoche
חלילוביטש	halilovic
ויקטור	victor
לאבי	lavie
קונויה	konoe
אסטודיאנטיס	estudiantes
טויוטא	toyota
סאנטאמאריא	santamaria
ביסה	bisset
גיורא	giora
ליקונא	lecuona
קאתמנדו	kathmandu
הולסטין	holstein
גרילא	grella
בירדזלי	beardsley
שיברוליי	chevrolet
וולקר	volcker
ליונהארד	leonhard
וארנר	warner
סוריאק	surjak
קאלוסט	calouste
קריסטופיאס	christofias
בארבארוסא	barbarossa
פיורי	fiori
דוסבורג	doesburg
סטאנדפיסט	standfest
דרק	derek
מורל	morrell
טירטלטאוב	turteltaub
בדראן	badran
קאקיהארא	kakihara
ראמי	rami
בירטולי	bertoli
טאניט	tanit
מוראסאקי	murasaki
ביצ'אסטניך	beschastnykh
מאמי	mami
אקרא	accra
ולקאן	volkan
סאמפראס	sampras
קואשימא	kuwashima
קמאל	kemal
מאורו	mauro
קופרניקוס	copernicus
ראטזל	ratzel
מורי	mauri
פאטי	patty
מאגנוס	magnus
שיכאוי	chikhaoui
באג'יו	baggio
מורא	maura
ג'ורג'ינז	georgians
ברויר	braugher
מאיקרוסופט	microsoft
קוירי	koyre
בריגיט	brigitte
ג'יאנאקאפולוס	giannakopoulos
גריבז	greaves
בלדל	bledel
ממדוח	mamdouh
ריבאק	rybak
רחמן	rahman
קונטי	conti
לורא	laura
יאסין	yassin
פוצו	pozzo
פוקס	foxx
קאיטאנו	cayetano
טאטסוקיצ'י	tatsukichi
רידון	redon
פילימון	phillimon
סאדק	sadegh
טריסטראם	tristram
ויסוצקי	vysotsky
צ'טרי	chhetri
סאמר	sammer
הוריקאוא	horikawa
איראקלי	irakli
מאטיוט	mateut
קלינקינבירד	clinkenbeard
גיורגי	gheorghe
פול	pol
סרנא	srna
סול	sol
פורלונג	furlong
ג'אורס	jaurs
בג	bg
יוריקא	jurica
גראנר	graner
מאנדי	mandy
קיסנורבו	kisnorbo
באקארדי	bacardi
סטריובסקי	sterjovski
אינגליש	english
הוסרל	husserl
מאנדי	mandi
מאנדא	manda
שין	shin
ג'ונסון	jonson
סאלח	salih
שילדון	sheldon
מירסאדקי	mirsadeghi
בוש	bush
ויולו	violeau
קונור	conor
בארטמאן	baartman
טיורל	theorell
באסטו	basto
זורר	zurer
מארקיז	marquez
מיאמוטו	miyamoto
סארינאנא	sarinana
לויג'י	luigi
סאמיטייר	samitier
עדי	adi
קארדוסו	cardoso
רובן	ruben
מוריקאוא	morikawa
אמארטיא	amartya
ליתואיניה	lithuania
דניאל	daniele
קוריע	qurei
אסטריד	astrid
נפתלי	naftali
מילוש	milos
ג'ון	jun
האמיט	hammett
גמאל	gamal
מארק	marc
עבדולאי	abdoulaye
וינדל	wendell
קירקלונד	kyrklund
מאנדאנדא	mandanda
קולין	colin
יאנדל	jandl
פהימה	fahima
קליי	klee
נאשיד	nasheed
שדיד	chedid
גמר	gamar
גאלי	ghali
מאקסימיליאן	maximilian
ניקלאס	nicklas
יאקושימא	yakushima
פוטאן	puttan
דימיטר	demeter
קונדירא	kundera
ראשא	russia
גולגי	golgi
אינדוריין	indurain
זרניאטנסקי	czerniatynski
גאלי	ghaly
מסא	mesa
ארבאטי	erbati
טיגוסיגאלפא	tegucigalpa
ביבו	vivo
עומר	umar
ספירו	spiro
באנטינג	bunting
ניאנג	niang
צ'יירו	cheyrou
עומר	omar
קדומי	kaddoumi
עמאר	amar
גופמאן	gofman
אימאר	emar
קוש	kusch
בומדין	boumediene
קראיובא	craiova
ארטו	arto
וליד	walid
סטאזי	stasi
ראחיל	rahel
טזניט	tiznit
רוסטוב	rostov
שיסטרניוב	shesternyov
ראבנדראנאת	rabindranath
חטא	hatta
מיהאילוביטש	mihajlovic
ליפמאן	lippmann
סירה	sira
לוקארנו	locarno
סאטיאגראהא	satyagraha
קאלפאט	kalfat
פרולין	proline
קירא	kira
ואטס	watts
מירא	mira
סאקסוני	saxony
וייסגלאס	weissglass
אשטאר	ishtar
סיניבאלדי	sinibaldi
סיטי	siti
מובעלי	mobali
ארייביאן	arabian
מטר	matar
גרסון	gerson
מאריון	marion
בויסון	buisson
גודוין	godwin
אקאסוסו	acasuso
הס	hess
פאולו	paulo
מודירי	modiri
חדאד	haddad
נסר	nasr
מאריאן	marian
מאגרב	maghreb
קורולנקוב	korolenkov
אודו	audo
ואסילי	vasile
סנבר	sanbar
שוץ	schutz
מיטוראי	mitoraj
ליוביסא	ljubisa
פאנטאנאל	pantanal
ליידי	lady
ג'ונסון	johnson
צ'אימאן	chaiman
פינאן	finnan
בלאס	blass
מאטי	matty
לונדין	lundin
באטו	batu
טריר	trier
קיוטי	quixote
מביקי	mbeki
סורי	suree
סאברינא	sabrina
יורי	yury
מאטי	matti
לימא	lima
נחמן	nahman
שקיב	chakib
פולסון	paulson
טיזוקא	tezuka
לומיר	lemerre
שירוקוב	shirokov
אריקסון	ericson
סאברי	sabri
לותייר	lothair
סוטון	sutton
היקל	haeckel
סימפסון	simpson
רביץ	ravitz
ויירון	veyron
לידלי	ledley
נאקא	naka
קולאר	collar
סטויקוביטש	stojkovic
בורילי	borrelli
ליונארדו	leonardo
גארנר	garner
נובוטל	novotel
באלאק	ballack
ר'גוב	rajoub
דוקאליון	deucalion
פיטס	pitts
פלה	pele
באנדו	bando
פירלו	pirlo
נאגאנו	nagano
מיריאם	miriam
אסטבאן	esteban
אספו	espoo
קורניליוס	cornelius
בנגאזי	benghazi
שאקיל	shaquille
אסמאעיל	ismail
דילי	dele
פורי	faure
טמו	temmu
קעבי	kaebi
בורדיו	bourdieu
לופר	lauper
שאהין	chahine
מארוא	marois
קורטוא	courtois
ברגמאיר	burgmeier
דושיר	duscher
סיניט	sennett
קוביין	cobain
זוארטקרויס	zwartkruis
זימין	zemin
גאלאסיק	galasek
סאידורניקו	sidorenko
מוריל	morell
מיקל	mikel
קוסטאקורטא	costacurta
פאקי	packie
רמזי	ramzy
ג'עפר	gaafar
מקליר	mcclair
בראזאוסקאס	brazauskas
יאנוביטש	janovic
דויקוביטש	dujkovic
מארסדן	marsden
פאנוצ'י	panucci
קורטני	courtney
אבוטארן	hebuterne
בוש	busch
רמזי	ramzi
טונקיי	tuncay
רוני	ronnie
קליפורד	clifford
מאליביטש	malevich
אילינוי	illinois
דאף	duff
טראנקוילו	tranquillo
סוהארטו	suharto
חאידר	heydar
מונדריאן	mondrian
מונג	monge
מיכאיל	mikhail
אוסמנט	osment
קורקמאז	korkmaz
חאמטאי	khamtai
ימין	yamin
אובאמא	obama
קופה	coupet
טאיפיי	taipei
ניוטאון	newtown
סדיר	sadir
מורן	muren
שרמאן	sherman
סקארלאטי	scarlatti
סטאנפורד	stanford
אדולף	adolphe
טיטא	titta
לינד	lindh
מונטקורט	montcourt
מאקינוא	makinwa
ברוקלין	brooklyn
דלגאדו	delgado
לינדא	linda
קוקבורן	cockburn
פארקאש	farkash
פאטירסון	patterson
ווד	wood
להיב	laheeb
צ'ישולם	chisholm
קארטירון	carteron
סופיאן	soufiane
שר	sher
ביטיני	bettini
ריוצ'י	ryoichi
בוסאצקי	bosacki
ראדיו	radio
האנטשובא	hantuchova
קארל	carle
חסן	hassan
לאטינז	latins
צ'ימאבו	cimabue
אמבארק	imbarek
קארלו	carlo
הוגאן	hogan
קונסטאנטין	constantine
בינקו	benko
בארימור	barrymore
לאהור	lahore
רופאלו	ruffalo
שבאינשטאיגר	schweinsteiger
זאט	zat
קוקארד	cocard
באקאו	bacau
פאט	pat
סאנקארא	sankara
ראט	rat
ואט	wat
האט	hat
קאלאדזה	kaladze
דיבון	devon
נאט	nat
מירי	miri
סיקס	six
קט	cat
ביזימונגו	bizimungu
ריביק	ribbeck
שקאקי	shaqaqi
באטא	batta
קיג'ורו	kijuro
שוארצמאן	schwartzmann
פירו	peru
באנאך	banach
ג'אפקא	djakpa
דיקס	dix
ריזואן	rizwan
אדמונד	edmond
פיסק	fisk
מארסל	marcel
צ'ולאפא	chulapa
יאמאמוטו	yamamoto
גייטס	gates
מאסינג	masing
עמאן	amman
עמאר	ammar
בראנדוארדי	branduardi
שויקאר	shwikar
סימור	seymour
באודרילארד	baudrillard
קריסטופר	christopher
תיסיוס	theseus
מנדלייב	mendeleev
לאנדשטאינר	landsteiner
יאגי	yaghi
דמיטרייב	dmitriyev
ויט	witte
נאטאנז	natanz
שיה	shih
מיטגוד	metgod
קהווג'י	kahwaji
פרייר	freier
ליצמאן	litzman
ויסם	wissem
מאלדאיבז	maldives
סטיפאניק	stepanek
קייזא	chiesa
ליבור	libor
דיריפאסקא	deripaska
ג'טין	cetin
צלאן	celan
סאסי	sassi
סדקי	sedki
דיי	dae
בלוגי	bellugi
פיי	fae
